
1;2;3;ADJ;DEF;IND;N;NOM;PFV;PL;POS;PST;SG;V;V.MSDR	kmr
1;2;3;COND;LGSPEC1;NEG;PL;PST;V;V.MSDR	kmr
1;2;3;COND;NEG;PL;PRF;PST;V	kmr
1;2;3;COND;NEG;PL;PST;V	kmr
1;2;3;COND;PL;POS;PRF;PST;V	kmr
1;2;3;COND;PL;POS;PST;V	kmr
1;2;3;DEF;IND;N;NOM;PFV;PL;POS;PST;SG;V;V.MSDR	kmr
1;2;3;DEF;IND;N;NOM;PFV;PL;POS;PST;SG;V;V.MSDR;ACC	kmr
1;2;3;IMP;NEG;PL;PRS;SBJV;V	kmr
1;2;3;IMP;PL;POS;PRS;SBJV;V	kmr
1;2;3;IND;NEG;PFV;PL;PST;V	kmr
1;2;3;IND;NEG;PFV;PL;PST;V;V.MSDR	kmr
1;2;3;IND;NEG;PL;PRF;PRS;V	kmr
1;2;3;IND;NEG;PL;PRF;PST;V	kmr
1;2;3;IND;NEG;PL;PRS;V;IPFV	kmr
1;2;3;IND;NEG;PL;PST;V;PROG	kmr
1;2;3;IND;PFV;PL;POS;PST;V	kmr
1;2;3;IND;PFV;PL;POS;PST;V;V.MSDR	kmr
1;2;3;IND;PL;POS;PRF;PRS;V	kmr
1;2;3;IND;PL;POS;PRF;PST;V	kmr
1;2;3;IND;PL;POS;PRS;V;IPFV	kmr
1;2;3;IND;PL;POS;PST;V;PROG	kmr
1;2;3;IND;PROG;NEG;PFV;PL;PRS;PST;SBJV;V	ckb
1;2;3;IND;PROG;PL;PRS;PST;V	ckb
1;COND;NEG;PL;PRF;PST;V	kmr
1;COND;NEG;PRF;PST;SG;V	kmr
1;COND;NEG;PST;SG;V	kmr
1;COND;POS;PRF;PST;SG;V	kmr
1;COND;POS;PST;SG;V	kmr
1;IND;NEG;PFV;PL;PST;V	ckb
1;IND;NEG;PFV;PST;SG;V	ckb, kmr
1;IND;NEG;PL;PRF;PRS;V	ckb
1;IND;NEG;PL;PRF;PST;V	ckb
1;IND;NEG;PRF;PRS;SG;V	ckb, kmr
1;IND;NEG;PRF;PST;SG;V	ckb, kmr
1;IND;NEG;PRS;SG;V;IPFV	kmr
1;IND;NEG;PST;SG;V;PROG	kmr
1;IND;PFV;PL;PST;V	ckb
1;IND;PFV;POS;PST;SG;V	kmr
1;IND;PFV;PST;SG;V	ckb
1;IND;PL;PRF;PRS;V	ckb
1;IND;PL;PRF;PST;V	ckb
1;IND;POS;PRF;PRS;SG;V	kmr
1;IND;POS;PRF;PST;SG;V	kmr
1;IND;POS;PRS;SG;V;IPFV	kmr
1;IND;POS;PST;SG;V;PROG	kmr
1;IND;PRF;PRS;SG;V	ckb
1;IND;PRF;PST;SG;V	ckb
1;IND;PROG;NEG;PASS;PL;PRS;V	ckb
1;IND;PROG;NEG;PASS;PRS;SG;V	ckb
1;IND;PROG;NEG;PFV;PL;PRS;PST;SBJV;V	ckb
1;IND;PROG;NEG;PFV;PRS;PST;SBJV;SG;V	ckb
1;IND;PROG;NEG;PL;PRS;V	ckb
1;IND;PROG;NEG;PRS;SG;V	ckb
1;IND;PROG;PASS;PL;PRS;V	ckb
1;IND;PROG;PASS;PRS;SG;V	ckb
1;IND;PROG;PL;PRS;PST;V	ckb
1;IND;PROG;PL;PRS;V	ckb
1;IND;PROG;PRS;PST;SG;V	ckb
1;IND;PROG;PRS;SG;V	ckb
1;NEG;PASS;PFV;PL;PST;SBJV;V	ckb
1;NEG;PASS;PFV;PL;PST;V	ckb
1;NEG;PASS;PFV;PST;SBJV;SG;V	ckb
1;NEG;PASS;PFV;PST;SG;V	ckb
1;NEG;PASS;PL;PRF;PRS;V	ckb
1;NEG;PASS;PL;PRF;PST;V	ckb
1;NEG;PASS;PRF;PRS;SG;V	ckb
1;NEG;PASS;PRF;PST;SG;V	ckb
1;NEG;PFV;PL;PST;SBJV;V	ckb
1;NEG;PFV;PL;PST;V	ckb
1;NEG;PFV;PST;SBJV;SG;V	ckb
1;NEG;PFV;PST;SG;V	ckb
1;NEG;PL;PRF;PRS;SBJV;V	ckb
1;NEG;PL;PRF;PST;SBJV;V	ckb
1;NEG;PRF;PRS;SBJV;SG;V	ckb
1;NEG;PRF;PST;SBJV;SG;V	ckb
1;NEG;PRS;SBJV;SG;V	kmr
1;PASS;PFV;PL;PST;SBJV;V	ckb
1;PASS;PFV;PL;PST;V	ckb
1;PASS;PFV;PST;SBJV;SG;V	ckb
1;PASS;PFV;PST;SG;V	ckb
1;PASS;PL;PRF;PRS;V	ckb
1;PASS;PL;PRF;PST;V	ckb
1;PASS;PRF;PRS;SG;V	ckb
1;PASS;PRF;PST;SG;V	ckb
1;PFV;PL;PST;SBJV;V	ckb
1;PFV;PL;PST;V	ckb
1;PFV;PST;SBJV;SG;V	ckb
1;PFV;PST;SG;V	ckb
1;PL;PRF;PRS;SBJV;V	ckb
1;PL;PRF;PST;SBJV;V	ckb
1;POS;PRS;SBJV;SG;V	kmr
1;PRF;PRS;SBJV;SG;V	ckb
1;PRF;PST;SBJV;SG;V	ckb
1;PROG;NEG;PASS;PL;PRS;SBJV;V	ckb
1;PROG;NEG;PASS;PL;PST;V	ckb
1;PROG;NEG;PASS;PRS;SBJV;SG;V	ckb
1;PROG;NEG;PASS;PST;SG;V	ckb
1;PROG;NEG;PL;PRS;SBJV;V	ckb
1;PROG;NEG;PL;PST;V	ckb
1;PROG;NEG;PRS;SBJV;SG;V	ckb
1;PROG;NEG;PST;SG;V	ckb
1;PROG;PASS;PL;PRS;SBJV;V	ckb
1;PROG;PASS;PL;PST;V	ckb
1;PROG;PASS;PRS;SBJV;SG;V	ckb
1;PROG;PASS;PST;SG;V	ckb
1;PROG;PL;PRS;SBJV;V	ckb
1;PROG;PL;PST;V	ckb
1;PROG;PRS;SBJV;SG;V	ckb
1;PROG;PST;SG;V	ckb
2;3;COND;NEG;PL;PRF;PST;V	kmr
2;3;COND;NEG;PRF;PST;SG;V	kmr
2;3;COND;NEG;PST;SG;V	kmr
2;3;COND;POS;PRF;PST;SG;V	kmr
2;3;COND;POS;PST;SG;V	kmr
2;3;IMP;PROG;PASS;PL;PRS;SBJV;V	ckb
2;3;IMP;PROG;PL;PRS;SBJV;V	ckb
2;3;IND;NEG;PFV;PL;PST;V	ckb
2;3;IND;NEG;PFV;PRS;PST;SBJV;SG;V;V.PTCP	kmr
2;3;IND;NEG;PL;PRF;PRS;V	ckb
2;3;IND;NEG;PL;PRF;PST;V	ckb
2;3;IND;NEG;PRF;PRS;SG;V	kmr
2;3;IND;NFIN;PFV;PL;PST;V	ckb
2;3;IND;PL;PRF;PRS;V	ckb
2;3;IND;PL;PRF;PST;V	ckb
2;3;IND;POS;PRF;PRS;SG;V	kmr
2;3;IND;POS;PRS;PST;SG;V;IPFV;PROG	kmr
2;3;IND;PROG;NEG;PASS;PL;PRS;V	ckb
2;3;IND;PROG;NEG;PFV;PL;PRS;PST;SBJV;V	ckb
2;3;IND;PROG;NEG;PFV;PRS;PST;SBJV;SG;V	ckb
2;3;IND;PROG;NEG;PL;PRS;V	ckb
2;3;IND;PROG;PASS;PL;PRS;V	ckb
2;3;IND;PROG;PL;PRS;PST;V	ckb
2;3;IND;PROG;PL;PRS;V	ckb
2;3;IND;PROG;PRS;PST;SG;V	ckb
2;3;NEG;PASS;PFV;PL;PST;SBJV;V	ckb
2;3;NEG;PASS;PFV;PL;PST;V	ckb
2;3;NEG;PASS;PL;PRF;PRS;V	ckb
2;3;NEG;PASS;PL;PRF;PST;V	ckb
2;3;NEG;PFV;PL;PST;SBJV;V	ckb
2;3;NEG;PL;PRF;PRS;SBJV;V	ckb
2;3;NEG;PL;PRF;PST;SBJV;V	ckb
2;3;NFIN;PASS;PFV;PL;PST;V	ckb
2;3;PASS;PFV;PL;PST;SBJV;V	ckb
2;3;PASS;PL;PRF;PRS;V	ckb
2;3;PASS;PL;PRF;PST;V	ckb
2;3;PFV;PL;PST;SBJV;V	ckb
2;3;PL;PRF;PRS;SBJV;V	ckb
2;3;PL;PRF;PST;SBJV;V	ckb
2;3;PROG;NEG;PASS;PL;PRS;SBJV;V	ckb
2;3;PROG;NEG;PASS;PL;PST;V	ckb
2;3;PROG;NEG;PL;PRS;SBJV;V	ckb
2;3;PROG;NEG;PL;PST;V	ckb
2;3;PROG;PASS;PL;PST;V	ckb
2;3;PROG;PL;PST;V	ckb
2;COND;NEG;PRF;PST;SG;V	kmr
2;COND;NEG;PST;SG;V	kmr
2;COND;POS;PRF;PST;SG;V	kmr
2;COND;POS;PST;SG;V	kmr
2;IND;NEG;PFV;PST;SG;V	ckb, kmr
2;IND;NEG;PFV;PST;SG;V;V.PTCP	kmr
2;IND;NEG;PL;PRF;PRS;V	ckb
2;IND;NEG;PL;PRF;PST;V	ckb
2;IND;NEG;PRF;PRS;SG;V	ckb, kmr
2;IND;NEG;PRF;PST;SG;V	ckb, kmr
2;IND;NEG;PRS;SG;V;IPFV	kmr
2;IND;NEG;PST;SG;V;PROG	kmr
2;IND;PFV;POS;PST;SG;V	kmr
2;IND;PFV;POS;PST;SG;V;V.PTCP	kmr
2;IND;PFV;PST;SG;V	ckb
2;IND;PL;PRF;PRS;V	ckb
2;IND;PL;PRF;PST;V	ckb
2;IND;POS;PRF;PST;SG;V	kmr
2;IND;POS;PRS;SG;V;IPFV	kmr
2;IND;POS;PST;SG;V;PROG	kmr
2;IND;PRF;PRS;SG;V	ckb
2;IND;PRF;PST;SG;V	ckb
2;IND;PROG;NEG;PASS;PRS;SG;V	ckb
2;IND;PROG;NEG;PFV;PRS;PST;SBJV;SG;V	ckb
2;IND;PROG;NEG;PRS;SG;V	ckb
2;IND;PROG;PASS;PRS;SG;V	ckb
2;IND;PROG;PRS;PST;SG;V	ckb
2;IND;PROG;PRS;SG;V	ckb
2;NEG;PASS;PFV;PST;SBJV;SG;V	ckb
2;NEG;PASS;PFV;PST;SG;V	ckb
2;NEG;PASS;PRF;PRS;SG;V	ckb
2;NEG;PASS;PRF;PST;SG;V	ckb
2;NEG;PFV;PL;PST;SBJV;V	ckb
2;NEG;PFV;PL;PST;V	ckb
2;NEG;PFV;PST;SBJV;SG;V	ckb
2;NEG;PFV;PST;SG;V	ckb
2;NEG;PL;PRF;PST;SBJV;V	ckb
2;NEG;PRF;PRS;SBJV;SG;V	ckb
2;NEG;PRF;PST;SBJV;SG;V	ckb
2;NEG;PRS;SBJV;SG;V	kmr
2;PASS;PFV;PST;SBJV;SG;V	ckb
2;PASS;PFV;PST;SG;V	ckb
2;PASS;PRF;PRS;SG;V	ckb
2;PASS;PRF;PST;SG;V	ckb
2;PFV;PL;PST;SBJV;V	ckb
2;PFV;PL;PST;V	ckb
2;PFV;PST;SBJV;SG;V	ckb
2;PFV;PST;SG;V	ckb
2;PL;PRF;PST;SBJV;V	ckb
2;POS;PRS;SBJV;SG;V	kmr
2;PRF;PRS;SBJV;SG;V	ckb
2;PRF;PST;SBJV;SG;V	ckb
2;PROG;NEG;PASS;PRS;SBJV;SG;V	ckb
2;PROG;NEG;PASS;PST;SG;V	ckb
2;PROG;NEG;PL;PST;V	ckb
2;PROG;NEG;PRS;SBJV;SG;V	ckb
2;PROG;NEG;PST;SG;V	ckb
2;PROG;PASS;PRS;SBJV;SG;V	ckb
2;PROG;PASS;PST;SG;V	ckb
2;PROG;PL;PST;V	ckb
2;PROG;PRS;SBJV;SG;V	ckb
2;PROG;PST;SG;V	ckb
3;COND;NEG;PRF;PST;SG;V	kmr
3;COND;NEG;PST;SG;V	kmr
3;COND;POS;PRF;PST;SG;V	kmr
3;COND;POS;PST;SG;V	kmr
3;IMP;NEG;PRS;SBJV;SG;V	kmr
3;IMP;POS;PRS;SBJV;SG;V	kmr
3;IND;NEG;PFV;PST;SG;V	ckb, kmr
3;IND;NEG;PL;PRF;PRS;V	ckb
3;IND;NEG;PL;PRF;PST;V	ckb
3;IND;NEG;PRF;PRS;SG;V	ckb, kmr
3;IND;NEG;PRF;PST;SG;V	ckb, kmr
3;IND;NEG;PRS;SG;V;IPFV	kmr
3;IND;NEG;PST;SG;V;PROG	kmr
3;IND;PFV;POS;PST;SG;V	kmr
3;IND;PFV;POS;PST;SG;V;V.PTCP	kmr
3;IND;PFV;PST;SG;V	ckb
3;IND;PL;PRF;PRS;V	ckb
3;IND;PL;PRF;PST;V	ckb
3;IND;POS;PRF;PST;SG;V	kmr
3;IND;POS;PRS;SG;V;IPFV	kmr
3;IND;POS;PST;SG;V;PROG	kmr
3;IND;PRF;PRS;SG;V	ckb
3;IND;PRF;PST;SG;V	ckb
3;IND;PROG;NEG;PASS;PRS;SG;V	ckb
3;IND;PROG;NEG;PRS;SG;V	ckb
3;IND;PROG;PASS;PRS;SG;V	ckb
3;IND;PROG;PRS;SG;V	ckb
3;NEG;PASS;PFV;PST;SBJV;SG;V	ckb
3;NEG;PASS;PFV;PST;SG;V	ckb
3;NEG;PASS;PRF;PRS;SG;V	ckb
3;NEG;PASS;PRF;PST;SG;V	ckb
3;NEG;PFV;PL;PST;SBJV;V	ckb
3;NEG;PFV;PL;PST;V	ckb
3;NEG;PFV;PST;SBJV;SG;V	ckb
3;NEG;PFV;PST;SG;V	ckb
3;NEG;PL;PRF;PST;SBJV;V	ckb
3;NEG;PRF;PRS;SBJV;SG;V	ckb
3;NEG;PRF;PST;SBJV;SG;V	ckb
3;PASS;PFV;PST;SBJV;SG;V	ckb
3;PASS;PFV;PST;SG;V	ckb
3;PASS;PRF;PRS;SG;V	ckb
3;PASS;PRF;PST;SG;V	ckb
3;PFV;PL;PST;SBJV;V	ckb
3;PFV;PL;PST;V	ckb
3;PFV;PST;SBJV;SG;V	ckb
3;PFV;PST;SG;V	ckb
3;PL;PRF;PST;SBJV;V	ckb
3;PRF;PRS;SBJV;SG;V	ckb
3;PRF;PST;SBJV;SG;V	ckb
3;PROG;NEG;PASS;PRS;SBJV;SG;V	ckb
3;PROG;NEG;PASS;PST;SG;V	ckb
3;PROG;NEG;PL;PST;V	ckb
3;PROG;NEG;PRS;SBJV;SG;V	ckb
3;PROG;NEG;PST;SG;V	ckb
3;PROG;PASS;PRS;SBJV;SG;V	ckb
3;PROG;PASS;PST;SG;V	ckb
3;PROG;PL;PST;V	ckb
3;PROG;PRS;SBJV;SG;V	ckb
3;PROG;PST;SG;V	ckb
ADJ;ABL; PL	lat
ADJ;ABL;FEM;SG	lat
ADJ;ABL;MASC/FEM;SG	lat
ADJ;ABL;MASC;SG	lat
ADJ;ABL;NEUT;SG	lat
ADJ;ABL;PL	que
ADJ;ABL;SG	que
ADJ;ACC;ANIM;MASC;SG	ces
ADJ;ACC;DU;ANIM	dsb
ADJ;ACC;DU;INAN	dsb
ADJ;ACC;FEM;PL	ces, lat
ADJ;ACC;FEM;SG	ces, dsb, fao, lat
ADJ;ACC;INAN;MASC;SG	ces
ADJ;ACC;MASC/FEM;PL	lat
ADJ;ACC;MASC/FEM;SG	lat
ADJ;ACC;MASC;PL	ces, fao, lat
ADJ;ACC;MASC;SG	ces, fao, lat
ADJ;ACC;MASC;SG;ANIM	dsb
ADJ;ACC;MASC;SG;INAN	dsb
ADJ;ACC;NEUT;PL	ces, lat
ADJ;ACC;NEUT;SG	ces, dsb, lat
ADJ;ACC;PL	ces, fin.1, fin.2, pol, que, sme
ADJ;ACC;PL;ANIM	dsb
ADJ;ACC;PL;FEM	lav
ADJ;ACC;PL;FEM;CMPR	lit
ADJ;ACC;PL;FEM;POS	lit
ADJ;ACC;PL;FEM;SPRL	lit
ADJ;ACC;PL;INAN	dsb
ADJ;ACC;PL;MASC	lav
ADJ;ACC;PL;MASC;CMPR	lit
ADJ;ACC;PL;MASC;POS	lit
ADJ;ACC;PL;MASC;SPRL	lit
ADJ;ACC;SG	fin.1, fin.2, que, sme
ADJ;ACC;SG;FEM	lav
ADJ;ACC;SG;FEM;CMPR	lit
ADJ;ACC;SG;FEM;POS	lit
ADJ;ACC;SG;FEM;SPRL	lit
ADJ;ACC;SG;MASC	lav
ADJ;ACC;SG;MASC;CMPR	lit
ADJ;ACC;SG;MASC;POS	lit
ADJ;ACC;SG;MASC;SPRL	lit
ADJ;ADP;DEF;N;NOM;PL;SG;ACC	kmr
ADJ;AT+ABL;PL	fin.1, fin.2
ADJ;AT+ABL;SG	fin.1, fin.2
ADJ;AT+ALL;PL	fin.1, fin.2
ADJ;AT+ALL;SG	fin.1, fin.2
ADJ;AT+ESS;PL	fin.1, fin.2
ADJ;AT+ESS;SG	fin.1, fin.2
ADJ;BEADJ;PL	que
ADJ;BEADJ;SG	que
ADJ;CAUSV;PL	que
ADJ;CAUSV;SG	que
ADJ;CMPR	gle, nno, nob
ADJ;COM;PL	fin.1, fin.2, que, sme
ADJ;COM;SG	que, sme
ADJ;COMPV;PL	que
ADJ;COMPV;SG	que
ADJ;DAT/GEN;FEM;SG;DEF	ron
ADJ;DAT/GEN;FEM;SG;INDF	ron
ADJ;DAT/GEN;MASC;SG;DEF	ron
ADJ;DAT/GEN;MASC;SG;INDF	ron
ADJ;DAT/GEN;NEUT;SG;DEF	ron
ADJ;DAT/GEN;NEUT;SG;INDF	ron
ADJ;DAT/GEN;PL;DEF	ron
ADJ;DAT/GEN;PL;INDF	ron
ADJ;DAT;DU	dsb
ADJ;DAT;FEM;SG	ces, dsb, fao, lat
ADJ;DAT;MASC/FEM;SG	lat
ADJ;DAT;MASC;PL	fao
ADJ;DAT;MASC;SG	ces, dsb, fao, lat
ADJ;DAT;NEUT;SG	ces, dsb, fao, lat
ADJ;DAT;PL	ces, dsb, gle, pol, que
ADJ;DAT;PL;FEM	lav
ADJ;DAT;PL;FEM;CMPR	lit
ADJ;DAT;PL;FEM;POS	lit
ADJ;DAT;PL;FEM;SPRL	lit
ADJ;DAT;PL;MASC	lav
ADJ;DAT;PL;MASC;CMPR	lit
ADJ;DAT;PL;MASC;POS	lit
ADJ;DAT;PL;MASC;SPRL	lit
ADJ;DAT;SG	que
ADJ;DAT;SG;FEM	gle, lav
ADJ;DAT;SG;FEM;CMPR	lit
ADJ;DAT;SG;FEM;POS	lit
ADJ;DAT;SG;FEM;SPRL	lit
ADJ;DAT;SG;MASC	gle, lav
ADJ;DAT;SG;MASC;CMPR	lit
ADJ;DAT;SG;MASC;POS	lit
ADJ;DAT;SG;MASC;SPRL	lit
ADJ;DEF	nld, nno, swe
ADJ;DEF;CMPR	nld
ADJ;DEF;COMPV	swe
ADJ;DEF;MASC;SG	swe
ADJ;DEF;MASC;SG;SPRL	swe
ADJ;DEF;N;NOM;PL;SG	kmr
ADJ;DEF;N;NOM;PL;SG;ACC	kmr
ADJ;DEF;N;PL	ckb
ADJ;DEF;N;PL;ACC;LGSPEC2	kmr
ADJ;DEF;N;SG	ckb
ADJ;DEF;PL	nno, nob
ADJ;DEF;SG	nno, nob
ADJ;DEF;SG+PL	nob
ADJ;DEF;SPRL	nld, nno, nob, swe
ADJ;DISTR;PL	que
ADJ;DISTR;SG	que
ADJ;ESS;DU	dsb
ADJ;ESS;FEM;SG	ces, dsb
ADJ;ESS;MASC;SG	ces, dsb
ADJ;ESS;NEUT;SG	ces, dsb
ADJ;ESS;PL	ces, dsb, pol, que
ADJ;ESS;SG	que
ADJ;EXCLV;PL	que
ADJ;EXCLV;SG	que
ADJ;FEM	nno
ADJ;FEM;ACC;DU	slv
ADJ;FEM;ACC;PL	slv
ADJ;FEM;ACC;SG	pol, slv
ADJ;FEM;DAT;DU	slv
ADJ;FEM;DAT;PL	slv
ADJ;FEM;DAT;SG	pol, slv
ADJ;FEM;ESS;DU	slv
ADJ;FEM;ESS;PL	slv
ADJ;FEM;ESS;SG	pol, slv
ADJ;FEM;GEN;DU	slv
ADJ;FEM;GEN;PL	slv
ADJ;FEM;GEN;SG	pol, slv
ADJ;FEM;INS;DU	slv
ADJ;FEM;INS;PL	slv
ADJ;FEM;INS;SG	pol, slv
ADJ;FEM;NOM;DU	slv
ADJ;FEM;NOM;PL	slv
ADJ;FEM;NOM;SG	pol, slv
ADJ;FEM;PL	fao
ADJ;FOC;N	ckb
ADJ;FRML;PL	fin.1, fin.2
ADJ;FRML;SG	fin.1, fin.2, sme
ADJ;GEADJ;PL	fin.1, fin.2, que
ADJ;GEADJ;SG	fin.1, fin.2, que
ADJ;GEN;DU	dsb
ADJ;GEN;FEM;PL	lat
ADJ;GEN;FEM;SG	ces, dsb, fao, lat
ADJ;GEN;MASC/FEM;SG	lat
ADJ;GEN;MASC;PL	fao, lat
ADJ;GEN;MASC;SG	ces, dsb, fao, lat
ADJ;GEN;NEUT;PL	lat
ADJ;GEN;NEUT;SG	ces, dsb, fao, lat
ADJ;GEN;PL	ces, dsb, pol, sme
ADJ;GEN;PL;FEM	lav
ADJ;GEN;PL;FEM;CMPR	lit
ADJ;GEN;PL;FEM;POS	lit
ADJ;GEN;PL;FEM;SPRL	lit
ADJ;GEN;PL;MASC	lav
ADJ;GEN;PL;MASC;CMPR	lit
ADJ;GEN;PL;MASC;POS	lit
ADJ;GEN;PL;MASC;SPRL	lit
ADJ;GEN;PL;STRONG	gle
ADJ;GEN;PL;WEAK	gle
ADJ;GEN;SG	sme
ADJ;GEN;SG;FEM	gle, lav
ADJ;GEN;SG;FEM;CMPR	lit
ADJ;GEN;SG;FEM;POS	lit
ADJ;GEN;SG;FEM;SPRL	lit
ADJ;GEN;SG;MASC	lav
ADJ;GEN;SG;MASC;CMPR	lit
ADJ;GEN;SG;MASC;POS	lit
ADJ;GEN;SG;MASC;SPRL	lit
ADJ;IN+ABL;PL	fin.1, fin.2
ADJ;IN+ABL;SG	fin.1, fin.2
ADJ;IN+ALL;PL	fin.1, fin.2, sme
ADJ;IN+ALL;SG	fin.1, fin.2, sme
ADJ;IN+ESS;PL	fin.1, fin.2
ADJ;IN+ESS;SG	fin.1, fin.2
ADJ;INDF;INFM;LGSPEC2;N;SG	ckb
ADJ;INDF;INFM;N;SG	ckb
ADJ;INDF;MASC;SG;COMPV	swe
ADJ;INDF;MASC+FEM;SG	swe
ADJ;INDF;MASC+FEM;SG;COMPV	swe
ADJ;INDF;MASC+FEM;SG;SPRL	swe
ADJ;INDF;N;PL	ckb
ADJ;INDF;N;PL;PSS1P	ckb
ADJ;INDF;N;SG	ckb
ADJ;INDF;NEUT;SG	nld, swe
ADJ;INDF;NEUT;SG;CMPR	nld
ADJ;INDF;NEUT;SG;COMPV	swe
ADJ;INDF;NEUT;SG;SPRL	nld, swe
ADJ;INDF;PL	nld, swe
ADJ;INDF;PL;CMPR	nld
ADJ;INDF;PL;COMPV	swe
ADJ;INDF;PL;SPRL	nld, swe
ADJ;INS;DU	dsb
ADJ;INS;FEM;SG	ces, dsb
ADJ;INS;MASC;SG	ces, dsb
ADJ;INS;NEUT;SG	ces, dsb
ADJ;INS;PL	ces, dsb, fin.1, fin.2, pol, que
ADJ;INS;SG	que
ADJ;INST;PL;FEM	lav
ADJ;INST;PL;FEM;CMPR	lit
ADJ;INST;PL;FEM;POS	lit
ADJ;INST;PL;FEM;SPRL	lit
ADJ;INST;PL;MASC	lav
ADJ;INST;PL;MASC;CMPR	lit
ADJ;INST;PL;MASC;POS	lit
ADJ;INST;PL;MASC;SPRL	lit
ADJ;INST;SG;FEM	lav
ADJ;INST;SG;FEM;CMPR	lit
ADJ;INST;SG;FEM;POS	lit
ADJ;INST;SG;FEM;SPRL	lit
ADJ;INST;SG;MASC	lav
ADJ;INST;SG;MASC;CMPR	lit
ADJ;INST;SG;MASC;POS	lit
ADJ;INST;SG;MASC;SPRL	lit
ADJ;INTER;PL	que
ADJ;INTER;SG	que
ADJ;LGSPEC1;LGSPEC2;1;PL;NEG;DECL	tur
ADJ;LGSPEC1;LGSPEC2;1;PL;NEG;INTR	tur
ADJ;LGSPEC1;LGSPEC2;1;PL;POS;DECL	tur
ADJ;LGSPEC1;LGSPEC2;1;PL;POS;INTR	tur
ADJ;LGSPEC1;LGSPEC2;1;SG;NEG;DECL	tur
ADJ;LGSPEC1;LGSPEC2;1;SG;NEG;INTR	tur
ADJ;LGSPEC1;LGSPEC2;1;SG;POS;DECL	tur
ADJ;LGSPEC1;LGSPEC2;1;SG;POS;INTR	tur
ADJ;LGSPEC1;LGSPEC2;2;PL;NEG;DECL	tur
ADJ;LGSPEC1;LGSPEC2;2;PL;NEG;INTR	tur
ADJ;LGSPEC1;LGSPEC2;2;PL;POS;DECL	tur
ADJ;LGSPEC1;LGSPEC2;2;PL;POS;INTR	tur
ADJ;LGSPEC1;LGSPEC2;2;SG;NEG;DECL	tur
ADJ;LGSPEC1;LGSPEC2;2;SG;NEG;INTR	tur
ADJ;LGSPEC1;LGSPEC2;2;SG;POS;DECL	tur
ADJ;LGSPEC1;LGSPEC2;2;SG;POS;INTR	tur
ADJ;LGSPEC1;LGSPEC2;3;PL;NEG;DECL	tur
ADJ;LGSPEC1;LGSPEC2;3;PL;NEG;INTR	tur
ADJ;LGSPEC1;LGSPEC2;3;PL;POS;DECL	tur
ADJ;LGSPEC1;LGSPEC2;3;PL;POS;INTR	tur
ADJ;LGSPEC1;LGSPEC2;3;SG;NEG;DECL	tur
ADJ;LGSPEC1;LGSPEC2;3;SG;NEG;INTR	tur
ADJ;LGSPEC1;LGSPEC2;3;SG;POS;DECL	tur
ADJ;LGSPEC1;LGSPEC2;3;SG;POS;INTR	tur
ADJ;LGSPEC1;N;PSS3S	ckb
ADJ;LGSPEC1;PRS;1;PL;NEG;DECL	tur
ADJ;LGSPEC1;PRS;1;PL;NEG;INTR	tur
ADJ;LGSPEC1;PRS;1;PL;POS;DECL	tur
ADJ;LGSPEC1;PRS;1;PL;POS;INTR	tur
ADJ;LGSPEC1;PRS;1;SG;NEG;DECL	tur
ADJ;LGSPEC1;PRS;1;SG;NEG;INTR	tur
ADJ;LGSPEC1;PRS;1;SG;POS;DECL	tur
ADJ;LGSPEC1;PRS;1;SG;POS;INTR	tur
ADJ;LGSPEC1;PRS;2;PL;NEG;DECL	tur
ADJ;LGSPEC1;PRS;2;PL;NEG;INTR	tur
ADJ;LGSPEC1;PRS;2;PL;POS;DECL	tur
ADJ;LGSPEC1;PRS;2;PL;POS;INTR	tur
ADJ;LGSPEC1;PRS;2;SG;NEG;DECL	tur
ADJ;LGSPEC1;PRS;2;SG;NEG;INTR	tur
ADJ;LGSPEC1;PRS;2;SG;POS;DECL	tur
ADJ;LGSPEC1;PRS;2;SG;POS;INTR	tur
ADJ;LGSPEC1;PRS;3;PL;NEG;DECL	tur
ADJ;LGSPEC1;PRS;3;PL;NEG;INTR	tur
ADJ;LGSPEC1;PRS;3;PL;POS;DECL	tur
ADJ;LGSPEC1;PRS;3;PL;POS;INTR	tur
ADJ;LGSPEC1;PRS;3;SG;NEG;DECL	tur
ADJ;LGSPEC1;PRS;3;SG;NEG;INTR	tur
ADJ;LGSPEC1;PRS;3;SG;POS;DECL	tur
ADJ;LGSPEC1;PRS;3;SG;POS;INTR	tur
ADJ;LGSPEC1;PST;1;PL;NEG;DECL	tur
ADJ;LGSPEC1;PST;1;PL;NEG;INTR	tur
ADJ;LGSPEC1;PST;1;PL;POS;DECL	tur
ADJ;LGSPEC1;PST;1;PL;POS;INTR	tur
ADJ;LGSPEC1;PST;1;SG;NEG;DECL	tur
ADJ;LGSPEC1;PST;1;SG;NEG;INTR	tur
ADJ;LGSPEC1;PST;1;SG;POS;DECL	tur
ADJ;LGSPEC1;PST;1;SG;POS;INTR	tur
ADJ;LGSPEC1;PST;2;PL;NEG;DECL	tur
ADJ;LGSPEC1;PST;2;PL;NEG;INTR	tur
ADJ;LGSPEC1;PST;2;PL;POS;DECL	tur
ADJ;LGSPEC1;PST;2;PL;POS;INTR	tur
ADJ;LGSPEC1;PST;2;SG;NEG;DECL	tur
ADJ;LGSPEC1;PST;2;SG;NEG;INTR	tur
ADJ;LGSPEC1;PST;2;SG;POS;DECL	tur
ADJ;LGSPEC1;PST;2;SG;POS;INTR	tur
ADJ;LGSPEC1;PST;3;PL;NEG;DECL	tur
ADJ;LGSPEC1;PST;3;PL;NEG;INTR	tur
ADJ;LGSPEC1;PST;3;PL;POS;DECL	tur
ADJ;LGSPEC1;PST;3;PL;POS;INTR	tur
ADJ;LGSPEC1;PST;3;SG;NEG;DECL	tur
ADJ;LGSPEC1;PST;3;SG;NEG;INTR	tur
ADJ;LGSPEC1;PST;3;SG;POS;DECL	tur
ADJ;LGSPEC1;PST;3;SG;POS;INTR	tur
ADJ;LGSPEC2;N	ckb
ADJ;LOC;PL;FEM	lav
ADJ;LOC;PL;FEM;CMPR	lit
ADJ;LOC;PL;FEM;POS	lit
ADJ;LOC;PL;FEM;SPRL	lit
ADJ;LOC;PL;MASC	lav
ADJ;LOC;PL;MASC;CMPR	lit
ADJ;LOC;PL;MASC;POS	lit
ADJ;LOC;PL;MASC;SPRL	lit
ADJ;LOC;SG;FEM	lav
ADJ;LOC;SG;FEM;CMPR	lit
ADJ;LOC;SG;FEM;POS	lit
ADJ;LOC;SG;FEM;SPRL	lit
ADJ;LOC;SG;MASC	lav
ADJ;LOC;SG;MASC;CMPR	lit
ADJ;LOC;SG;MASC;POS	lit
ADJ;LOC;SG;MASC;SPRL	lit
ADJ;MASC	nno
ADJ;MASC;ACC;DU	slv
ADJ;MASC;ACC;PL	slv
ADJ;MASC;ANIM;ACC;SG	pol
ADJ;MASC;DAT;DU	slv
ADJ;MASC;DAT;PL	slv
ADJ;MASC;DAT;SG	pol, slv
ADJ;MASC;ESS;DU	slv
ADJ;MASC;ESS;PL	slv
ADJ;MASC;ESS;SG	pol, slv
ADJ;MASC;GEN;DU	slv
ADJ;MASC;GEN;PL	slv
ADJ;MASC;GEN;SG	pol, slv
ADJ;MASC;HUM;ACC;PL	pol
ADJ;MASC;HUM;ACC;SG	pol
ADJ;MASC;HUM;NOM;PL	pol
ADJ;MASC;INAN;ACC;SG	pol
ADJ;MASC;INS;DU	slv
ADJ;MASC;INS;PL	slv
ADJ;MASC;INS;SG	pol, slv
ADJ;MASC;NOM;DU	slv
ADJ;MASC;NOM;PL	slv
ADJ;MASC;NOM;SG	pol, slv
ADJ;MASC;NOM;SG;DEF	slv
ADJ;MASC;NOM;SG;INDF	slv
ADJ;MASC+FEM	nno
ADJ;N	ckb, kmr
ADJ;N;NUM	kmr
ADJ;N;PROX	ckb
ADJ;N;PSS1P	ckb
ADJ;N;PSS1S	ckb
ADJ;N;PSS2P	ckb
ADJ;N;PSS2S	ckb
ADJ;N;PSS3P	ckb
ADJ;N;REMT	ckb
ADJ;NDEF;NEUT;SG	nno, nob
ADJ;NDEF;PL	nob
ADJ;NDEF;SG	nno
ADJ;NDEF;SPRL	nno, nob
ADJ;NEUT	nno, nob
ADJ;NEUT;ACC;DU	slv
ADJ;NEUT;ACC;PL	slv
ADJ;NEUT;ACC;SG	pol, slv
ADJ;NEUT;DAT;DU	slv
ADJ;NEUT;DAT;PL	slv
ADJ;NEUT;DAT;SG	pol, slv
ADJ;NEUT;ESS;DU	slv
ADJ;NEUT;ESS;PL	slv
ADJ;NEUT;ESS;SG	pol, slv
ADJ;NEUT;GEN;DU	slv
ADJ;NEUT;GEN;PL	slv
ADJ;NEUT;GEN;SG	pol, slv
ADJ;NEUT;INS;DU	slv
ADJ;NEUT;INS;PL	slv
ADJ;NEUT;INS;SG	pol, slv
ADJ;NEUT;NOM;DU	slv
ADJ;NEUT;NOM;PL	slv
ADJ;NEUT;NOM;SG	pol, slv
ADJ;NEUT;PL	fao
ADJ;NEUT;SG	nno, nob
ADJ;NOM/ACC;FEM;SG;DEF	ron
ADJ;NOM/ACC;FEM;SG;INDF	ron
ADJ;NOM/ACC;MASC;SG;DEF	ron
ADJ;NOM/ACC;MASC;SG;INDF	ron
ADJ;NOM/ACC;NEUT;SG	fao
ADJ;NOM/ACC;NEUT;SG;DEF	ron
ADJ;NOM/ACC;NEUT;SG;INDF	ron
ADJ;NOM/ACC;PL;DEF	ron
ADJ;NOM/ACC;PL;INDF	ron
ADJ;NOM;ANIM;MASC;PL	ces
ADJ;NOM;DU	dsb
ADJ;NOM;FEM;PL	ces, lat
ADJ;NOM;FEM;SG	ces, dsb, fao, lat
ADJ;NOM;MASC/FEM;PL	lat
ADJ;NOM;MASC/FEM;SG	lat
ADJ;NOM;MASC;PL	ces, fao, lat
ADJ;NOM;MASC;SG	ces, dsb, fao, lat
ADJ;NOM;NEUT;PL	ces, lat
ADJ;NOM;NEUT;SG	ces, dsb, lat
ADJ;NOM;PL	ces, dsb, fin.1, fin.2, gle, pol, que, sme
ADJ;NOM;PL;FEM	lav
ADJ;NOM;PL;FEM;CMPR	lit
ADJ;NOM;PL;FEM;POS	lit
ADJ;NOM;PL;FEM;SPRL	lit
ADJ;NOM;PL;MASC	lav
ADJ;NOM;PL;MASC;CMPR	lit
ADJ;NOM;PL;MASC;POS	lit
ADJ;NOM;PL;MASC;SPRL	lit
ADJ;NOM;SG	ces, fin.1, fin.2, que, sme
ADJ;NOM;SG;FEM	lav
ADJ;NOM;SG;FEM;CMPR	lit
ADJ;NOM;SG;FEM;POS	lit
ADJ;NOM;SG;FEM;SPRL	lit
ADJ;NOM;SG;MASC	gle, lav
ADJ;NOM;SG;MASC;CMPR	lit
ADJ;NOM;SG;MASC;POS	lit
ADJ;NOM;SG;MASC;SPRL	lit
ADJ;NOM+VOC;SG;FEM	gle
ADJ;PL;DAT	gla
ADJ;PL;GEN	gla
ADJ;PL;NOM	gla
ADJ;PL;VOC	gla
ADJ;PRIV;PL	fin.1, fin.2, que
ADJ;PRIV;SG	fin.1, fin.2, que
ADJ;PRP;PL	sme
ADJ;PRP;SG	sme
ADJ;PRT;PL	fin.1, fin.2
ADJ;PRT;SG	fin.1, fin.2
ADJ;PSS1PE;ABL;PL	que
ADJ;PSS1PE;ABL;SG	que
ADJ;PSS1PE;ACC;PL	que
ADJ;PSS1PE;ACC;SG	que
ADJ;PSS1PE;BEADJ;PSS1PE;PL	que
ADJ;PSS1PE;BEADJ;PSS1PE;SG	que
ADJ;PSS1PE;CAUSV;PL	que
ADJ;PSS1PE;CAUSV;SG	que
ADJ;PSS1PE;COM;PL	que
ADJ;PSS1PE;COM;SG	que
ADJ;PSS1PE;COMPV;PL	que
ADJ;PSS1PE;COMPV;SG	que
ADJ;PSS1PE;DAT;PL	que
ADJ;PSS1PE;DAT;SG	que
ADJ;PSS1PE;DISTR;PL	que
ADJ;PSS1PE;DISTR;SG	que
ADJ;PSS1PE;ESS;PL	que
ADJ;PSS1PE;ESS;SG	que
ADJ;PSS1PE;EXCLV;PL	que
ADJ;PSS1PE;EXCLV;SG	que
ADJ;PSS1PE;GEADJ;PSS1PE;PL	que
ADJ;PSS1PE;GEADJ;PSS1PE;SG	que
ADJ;PSS1PE;INS;PL	que
ADJ;PSS1PE;INS;SG	que
ADJ;PSS1PE;INTER;PL	que
ADJ;PSS1PE;INTER;SG	que
ADJ;PSS1PE;NOM;PL	que
ADJ;PSS1PE;NOM;SG	que
ADJ;PSS1PE;PRIV;PL	que
ADJ;PSS1PE;PRIV;SG	que
ADJ;PSS1PE;TERM;PL	que
ADJ;PSS1PE;TERM;SG	que
ADJ;PSS1PI;ABL;PL	que
ADJ;PSS1PI;ABL;SG	que
ADJ;PSS1PI;ACC;PL	que
ADJ;PSS1PI;ACC;SG	que
ADJ;PSS1PI;BEADJ;PSS1PI;PL	que
ADJ;PSS1PI;BEADJ;PSS1PI;SG	que
ADJ;PSS1PI;CAUSV;PL	que
ADJ;PSS1PI;CAUSV;SG	que
ADJ;PSS1PI;COM;PL	que
ADJ;PSS1PI;COM;SG	que
ADJ;PSS1PI;COMPV;PL	que
ADJ;PSS1PI;COMPV;SG	que
ADJ;PSS1PI;DAT;PL	que
ADJ;PSS1PI;DAT;SG	que
ADJ;PSS1PI;DISTR;PL	que
ADJ;PSS1PI;DISTR;SG	que
ADJ;PSS1PI;ESS;PL	que
ADJ;PSS1PI;ESS;SG	que
ADJ;PSS1PI;EXCLV;PL	que
ADJ;PSS1PI;EXCLV;SG	que
ADJ;PSS1PI;GEADJ;PSS1PI;PL	que
ADJ;PSS1PI;GEADJ;PSS1PI;SG	que
ADJ;PSS1PI;INS;PL	que
ADJ;PSS1PI;INS;SG	que
ADJ;PSS1PI;INTER;PL	que
ADJ;PSS1PI;INTER;SG	que
ADJ;PSS1PI;NOM;PL	que
ADJ;PSS1PI;NOM;SG	que
ADJ;PSS1PI;PRIV;PL	que
ADJ;PSS1PI;PRIV;SG	que
ADJ;PSS1PI;TERM;PL	que
ADJ;PSS1PI;TERM;SG	que
ADJ;PSS1S;ABL;PL	que
ADJ;PSS1S;ABL;SG	que
ADJ;PSS1S;ACC;PL	que
ADJ;PSS1S;ACC;SG	que
ADJ;PSS1S;BEADJ;PSS1S;PL	que
ADJ;PSS1S;BEADJ;PSS1S;SG	que
ADJ;PSS1S;CAUSV;PL	que
ADJ;PSS1S;CAUSV;SG	que
ADJ;PSS1S;COM;PL	que
ADJ;PSS1S;COM;SG	que
ADJ;PSS1S;COMPV;PL	que
ADJ;PSS1S;COMPV;SG	que
ADJ;PSS1S;DAT;PL	que
ADJ;PSS1S;DAT;SG	que
ADJ;PSS1S;DISTR;PL	que
ADJ;PSS1S;DISTR;SG	que
ADJ;PSS1S;ESS;PL	que
ADJ;PSS1S;ESS;SG	que
ADJ;PSS1S;EXCLV;PL	que
ADJ;PSS1S;EXCLV;SG	que
ADJ;PSS1S;GEADJ;PSS1S;PL	que
ADJ;PSS1S;GEADJ;PSS1S;SG	que
ADJ;PSS1S;INS;PL	que
ADJ;PSS1S;INS;SG	que
ADJ;PSS1S;INTER;PL	que
ADJ;PSS1S;INTER;SG	que
ADJ;PSS1S;NOM;PL	que
ADJ;PSS1S;NOM;SG	que
ADJ;PSS1S;PRIV;PL	que
ADJ;PSS1S;PRIV;SG	que
ADJ;PSS1S;TERM;PL	que
ADJ;PSS1S;TERM;SG	que
ADJ;PSS2P;ABL;PL	que
ADJ;PSS2P;ABL;SG	que
ADJ;PSS2P;ACC;PL	que
ADJ;PSS2P;ACC;SG	que
ADJ;PSS2P;BEADJ;PSS2P;PL	que
ADJ;PSS2P;BEADJ;PSS2P;SG	que
ADJ;PSS2P;CAUSV;PL	que
ADJ;PSS2P;CAUSV;SG	que
ADJ;PSS2P;COM;PL	que
ADJ;PSS2P;COM;SG	que
ADJ;PSS2P;COMPV;PL	que
ADJ;PSS2P;COMPV;SG	que
ADJ;PSS2P;DAT;PL	que
ADJ;PSS2P;DAT;SG	que
ADJ;PSS2P;DISTR;PL	que
ADJ;PSS2P;DISTR;SG	que
ADJ;PSS2P;ESS;PL	que
ADJ;PSS2P;ESS;SG	que
ADJ;PSS2P;EXCLV;PL	que
ADJ;PSS2P;EXCLV;SG	que
ADJ;PSS2P;GEADJ;PSS2P;PL	que
ADJ;PSS2P;GEADJ;PSS2P;SG	que
ADJ;PSS2P;INS;PL	que
ADJ;PSS2P;INS;SG	que
ADJ;PSS2P;INTER;PL	que
ADJ;PSS2P;INTER;SG	que
ADJ;PSS2P;NOM;PL	que
ADJ;PSS2P;NOM;SG	que
ADJ;PSS2P;PRIV;PL	que
ADJ;PSS2P;PRIV;SG	que
ADJ;PSS2P;TERM;PL	que
ADJ;PSS2P;TERM;SG	que
ADJ;PSS2S;ABL;PL	que
ADJ;PSS2S;ABL;SG	que
ADJ;PSS2S;ACC;PL	que
ADJ;PSS2S;ACC;SG	que
ADJ;PSS2S;BEADJ;PSS2S;PL	que
ADJ;PSS2S;BEADJ;PSS2S;SG	que
ADJ;PSS2S;CAUSV;PL	que
ADJ;PSS2S;CAUSV;SG	que
ADJ;PSS2S;COM;PL	que
ADJ;PSS2S;COM;SG	que
ADJ;PSS2S;COMPV;PL	que
ADJ;PSS2S;COMPV;SG	que
ADJ;PSS2S;DAT;PL	que
ADJ;PSS2S;DAT;SG	que
ADJ;PSS2S;DISTR;PL	que
ADJ;PSS2S;DISTR;SG	que
ADJ;PSS2S;ESS;PL	que
ADJ;PSS2S;ESS;SG	que
ADJ;PSS2S;EXCLV;PL	que
ADJ;PSS2S;EXCLV;SG	que
ADJ;PSS2S;GEADJ;PSS2S;PL	que
ADJ;PSS2S;GEADJ;PSS2S;SG	que
ADJ;PSS2S;INS;PL	que
ADJ;PSS2S;INS;SG	que
ADJ;PSS2S;INTER;PL	que
ADJ;PSS2S;INTER;SG	que
ADJ;PSS2S;NOM;PL	que
ADJ;PSS2S;NOM;SG	que
ADJ;PSS2S;PRIV;PL	que
ADJ;PSS2S;PRIV;SG	que
ADJ;PSS2S;TERM;PL	que
ADJ;PSS2S;TERM;SG	que
ADJ;PSS3P;ABL;PL	que
ADJ;PSS3P;ABL;SG	que
ADJ;PSS3P;ACC;PL	que
ADJ;PSS3P;ACC;SG	que
ADJ;PSS3P;BEADJ;PSS3P;PL	que
ADJ;PSS3P;BEADJ;PSS3P;SG	que
ADJ;PSS3P;CAUSV;PL	que
ADJ;PSS3P;CAUSV;SG	que
ADJ;PSS3P;COM;PL	que
ADJ;PSS3P;COM;SG	que
ADJ;PSS3P;COMPV;PL	que
ADJ;PSS3P;COMPV;SG	que
ADJ;PSS3P;DAT;PL	que
ADJ;PSS3P;DAT;SG	que
ADJ;PSS3P;DISTR;PL	que
ADJ;PSS3P;DISTR;SG	que
ADJ;PSS3P;ESS;PL	que
ADJ;PSS3P;ESS;SG	que
ADJ;PSS3P;EXCLV;PL	que
ADJ;PSS3P;EXCLV;SG	que
ADJ;PSS3P;GEADJ;PSS3P;PL	que
ADJ;PSS3P;GEADJ;PSS3P;SG	que
ADJ;PSS3P;INS;PL	que
ADJ;PSS3P;INS;SG	que
ADJ;PSS3P;INTER;PL	que
ADJ;PSS3P;INTER;SG	que
ADJ;PSS3P;NOM;PL	que
ADJ;PSS3P;NOM;SG	que
ADJ;PSS3P;PRIV;PL	que
ADJ;PSS3P;PRIV;SG	que
ADJ;PSS3P;TERM;PL	que
ADJ;PSS3P;TERM;SG	que
ADJ;PSS3S;ABL;PL	que
ADJ;PSS3S;ABL;SG	que
ADJ;PSS3S;ACC;PL	que
ADJ;PSS3S;ACC;SG	que
ADJ;PSS3S;BEADJ;PSS3S;PL	que
ADJ;PSS3S;BEADJ;PSS3S;SG	que
ADJ;PSS3S;CAUSV;PL	que
ADJ;PSS3S;CAUSV;SG	que
ADJ;PSS3S;COM;PL	que
ADJ;PSS3S;COM;SG	que
ADJ;PSS3S;COMPV;PL	que
ADJ;PSS3S;COMPV;SG	que
ADJ;PSS3S;DAT;PL	que
ADJ;PSS3S;DAT;SG	que
ADJ;PSS3S;DISTR;PL	que
ADJ;PSS3S;DISTR;SG	que
ADJ;PSS3S;ESS;PL	que
ADJ;PSS3S;ESS;SG	que
ADJ;PSS3S;EXCLV;PL	que
ADJ;PSS3S;EXCLV;SG	que
ADJ;PSS3S;GEADJ;PSS3S;PL	que
ADJ;PSS3S;GEADJ;PSS3S;SG	que
ADJ;PSS3S;INS;PL	que
ADJ;PSS3S;INS;SG	que
ADJ;PSS3S;INTER;PL	que
ADJ;PSS3S;INTER;SG	que
ADJ;PSS3S;NOM;PL	que
ADJ;PSS3S;NOM;SG	que
ADJ;PSS3S;PRIV;PL	que
ADJ;PSS3S;PRIV;SG	que
ADJ;PSS3S;TERM;PL	que
ADJ;PSS3S;TERM;SG	que
ADJ;SG;FEM;DAT	gla
ADJ;SG;FEM;GEN	gla
ADJ;SG;FEM;NOM	gla
ADJ;SG;FEM;VOC	gla
ADJ;SG;MASC;DAT	gla
ADJ;SG;MASC;GEN	gla
ADJ;SG;MASC;NOM	gla
ADJ;SG;MASC;VOC	gla
ADJ;SG+PL	nno
ADJ;SPRL	gle, nno, nob
ADJ;TERM;PL	que
ADJ;TERM;SG	que
ADJ;TRANS;PL	fin.1, fin.2
ADJ;TRANS;SG	fin.1, fin.2
ADJ;VOC;ANIM;MASC;PL	ces
ADJ;VOC;FEM;PL	ces, lat
ADJ;VOC;FEM;SG	ces, lat
ADJ;VOC;MASC/FEM;PL	lat
ADJ;VOC;MASC/FEM;SG	lat
ADJ;VOC;MASC;PL	ces, lat
ADJ;VOC;MASC;SG	ces, lat
ADJ;VOC;NEUT;PL	ces, lat
ADJ;VOC;NEUT;SG	ces, lat
ADJ;VOC;PL	ces, gle
ADJ;VOC;PL;FEM;POS	lit
ADJ;VOC;PL;MASC;POS	lit
ADJ;VOC;SG	ces
ADJ;VOC;SG;FEM;POS	lit
ADJ;VOC;SG;MASC;POS	lit
ADJ;VOC+GEN;SG;MASV	gle
ADP;DEF;N;NOM;PL;SG;ACC	kmr
DEF;LGSPEC1;N;PL;VOC	kmr
DEF;LGSPEC1;N;SG	kmr
DEF;LGSPEC1;N;SG;V;V.MSDR	kmr
DEF;LGSPEC1;N;SG;V;V.MSDR;VOC;ACC;LGSPEC2	kmr
DEF;LGSPEC1;N;SG;VOC;ACC;LGSPEC2	kmr
DEF;N;NOM;PL;SG	kmr
DEF;N;NOM;PL;SG;ACC	kmr
DEF;N;PL	ckb
DEF;N;PL;ACC;LGSPEC2	kmr
DEF;N;PL;VOC	kmr
DEF;N;SG	ckb
DEF;N;SG;LGSPEC2	kmr
DEF;N;SG;V;V.MSDR;VOC;ACC;LGSPEC2	kmr
DEF;N;SG;VOC	kmr
DEF;N;SG;VOC;ACC;LGSPEC2	kmr
FOC;N	ckb
IMP;NEG;PASS;PL;V	ckb
IMP;NEG;PASS;SG;V	ckb
IMP;NEG;PL;V	ckb
IMP;NEG;SG;V	ckb
IMP;PASS;SG;V	ckb
IMP;SG;V	ckb
INDF;INFM;N;SG	ckb
INDF;LGSPEC1;N;PL	kmr
INDF;LGSPEC1;N;SG;ACC	kmr
INDF;N;NOM;PL	kmr
INDF;N;NOM;SG	kmr
INDF;N;PL	ckb
INDF;N;PL;ACC	kmr
INDF;N;PL;PSS3P	ckb
INDF;N;SG	ckb
LGSPEC1;N;PSS3S	ckb
LGSPEC1;NEG;V;V.MSDR	kmr
LGSPEC1;V;V.MSDR	kmr
LGSPEC2;N	ckb
N;ABL;PL	lat, que, tur
N;ABL;PL;DEF	sqi
N;ABL;PL;NDEF	sqi
N;ABL;PL;PSS1P	tur
N;ABL;PL;PSS2P	tur
N;ABL;PL;PSS2S	tur
N;ABL;PL;PSS3P	tur
N;ABL;PL;PSS3S	tur
N;ABL;SG	lat, que, tur
N;ABL;SG;DEF	sqi
N;ABL;SG;NDEF	sqi
N;ABL;SG;PSS1P	tur
N;ABL;SG;PSS2P	tur
N;ABL;SG;PSS2S	tur
N;ABL;SG;PSS3P	tur
N;ABL;SG;PSS3S	tur
N;ACC;ANIM;PL	ces
N;ACC;ANIM;SG	ces
N;ACC;DU	dsb, slv
N;ACC;INAN;PL	ces
N;ACC;INAN;SG	ces
N;ACC;PL	ces, deu, dsb, est, fin.1, fin.2, hun, lat, lav, lit, pol, que, slv, sme, tur
N;ACC;PL;DEF	sqi
N;ACC;PL;NDEF	sqi
N;ACC;PL;PSS1P	tur
N;ACC;PL;PSS2P	tur
N;ACC;PL;PSS2S	tur
N;ACC;PL;PSS3P	tur
N;ACC;PL;PSS3S	tur
N;ACC;SG	ces, deu, dsb, est, fin.1, fin.2, hun, lat, lav, lit, pol, que, slv, sme, tur
N;ACC;SG;DEF	sqi
N;ACC;SG;NDEF	sqi
N;ACC;SG;PSS1P	tur
N;ACC;SG;PSS2P	tur
N;ACC;SG;PSS2S	tur
N;ACC;SG;PSS3P	tur
N;ACC;SG;PSS3S	tur
N;AT+ABL;PL	est, fin.1, fin.2, hun
N;AT+ABL;SG	est, fin.1, fin.2, hun
N;AT+ALL;PL	est, fin.1, fin.2, hun
N;AT+ALL;SG	est, fin.1, fin.2, hun
N;AT+ESS;PL	est, fin.1, fin.2, hun
N;AT+ESS;SG	est, fin.1, fin.2, hun
N;BEN;PL	que
N;BEN;SG	que
N;CAUSV;PL	que
N;CAUSV;SG	que
N;COM;PL	est, fin.1, fin.2, que, sme
N;COM;SG	est, que, sme
N;COMPV;PL	que
N;COMPV;SG	que
N;DAT	nno, nob
N;DAT;ANIM;PL	ces
N;DAT;ANIM;SG	ces
N;DAT;DU	dsb, slv
N;DAT;INAN;PL	ces
N;DAT;INAN;SG	ces
N;DAT;PL	ces, deu, dsb, gle, hun, lat, lav, lit, pol, que, slv, tur
N;DAT;PL;DEF	gle, sqi
N;DAT;PL;NDEF	sqi
N;DAT;PL;PSS1P	tur
N;DAT;PL;PSS2P	tur
N;DAT;PL;PSS2S	tur
N;DAT;PL;PSS3P	tur
N;DAT;PL;PSS3S	tur
N;DAT;SG	ces, deu, dsb, gle, hun, lat, lav, lit, pol, que, slv, tur
N;DAT;SG;DEF	gle, sqi
N;DAT;SG;NDEF	sqi
N;DAT;SG;PSS1P	tur
N;DAT;SG;PSS2P	tur
N;DAT;SG;PSS2S	tur
N;DAT;SG;PSS3P	tur
N;DAT;SG;PSS3S	tur
N;DEF;ACC;PL	fao, isl
N;DEF;ACC;SG	fao, isl
N;DEF;DAT;PL	fao, isl
N;DEF;DAT;SG	fao, isl
N;DEF;GEN;PL	fao, isl, swe
N;DEF;GEN;SG	fao, isl, swe
N;DEF;NOM;PL	dan, fao, isl, swe
N;DEF;NOM;SG	dan, fao, isl, swe
N;DEF;PL	nno, nob
N;DEF;SG	nno, nob
N;DEF;SG+PL	nno
N;DISTR;PL	que
N;DISTR;SG	que
N;ESS;ANIM;PL	ces
N;ESS;ANIM;SG	ces
N;ESS;DU	dsb, slv
N;ESS;INAN;PL	ces
N;ESS;INAN;SG	ces
N;ESS;PL	ces, dsb, pol, que, slv
N;ESS;SG	ces, dsb, pol, que, slv
N;EXCLV;PL	que
N;EXCLV;SG	que
N;FRML;PL	est, fin.1, fin.2, hun
N;FRML;SG	est, fin.1, fin.2, hun, sme
N;GEN	nob
N;GEN/DAT;PL;DEF	ron
N;GEN/DAT;SG;INDF	ron
N;GEN;ANIM;PL	ces
N;GEN;ANIM;SG	ces
N;GEN;DU	dsb, slv
N;GEN;INAN;PL	ces
N;GEN;INAN;SG	ces
N;GEN;PL	ces, deu, dsb, est, fin.1, fin.2, gle, lat, lav, lit, pol, que, slv, sme, tur
N;GEN;PL;DEF	sqi
N;GEN;PL;NDEF	sqi
N;GEN;PL;PSS1P	tur
N;GEN;PL;PSS2P	tur
N;GEN;PL;PSS2S	tur
N;GEN;PL;PSS3P	tur
N;GEN;PL;PSS3S	tur
N;GEN;SG	ces, deu, dsb, est, fin.1, fin.2, gle, lat, lav, lit, pol, que, slv, sme, tur
N;GEN;SG;DEF	gle, sqi
N;GEN;SG;NDEF	sqi
N;GEN;SG;PSS1P	tur
N;GEN;SG;PSS2P	tur
N;GEN;SG;PSS2S	tur
N;GEN;SG;PSS3P	tur
N;GEN;SG;PSS3S	tur
N;IN+ABL;PL	est, fin.1, fin.2, hun
N;IN+ABL;SG	est, fin.1, fin.2, hun
N;IN+ALL;PL	est, fin.1, fin.2, hun, sme
N;IN+ALL;SG	est, fin.1, fin.2, hun, sme
N;IN+ESS;PL	est, fin.1, fin.2, hun
N;IN+ESS;SG	est, fin.1, fin.2, hun
N;INDF;ACC;PL	fao, isl
N;INDF;ACC;SG	fao, isl
N;INDF;DAT;PL	fao, isl
N;INDF;DAT;SG	fao, isl
N;INDF;GEN;PL	dan, fao, isl, swe
N;INDF;GEN;SG	dan, fao, isl, swe
N;INDF;NOM;PL	dan, fao, isl, swe
N;INDF;NOM;SG	dan, fao, isl, swe
N;INS;ANIM;PL	ces
N;INS;ANIM;SG	ces
N;INS;DU	dsb, slv
N;INS;INAN;PL	ces
N;INS;INAN;SG	ces
N;INS;PL	ces, dsb, fin.1, fin.2, pol, que, slv
N;INS;SG	ces, dsb, pol, que, slv
N;INST;PL	hun, lav, lit
N;INST;SG	hun, lav, lit
N;INTER;PL	que
N;INTER;SG	que
N;LGSPEC1;1P;PL;LGSPEC2	tur
N;LGSPEC1;1P;PL;PRS	tur
N;LGSPEC1;1P;PL;PST	tur
N;LGSPEC1;1P;SG;LGSPEC2	tur
N;LGSPEC1;1P;SG;PRS	tur
N;LGSPEC1;1P;SG;PST	tur
N;LGSPEC1;1S;PL;LGSPEC2	tur
N;LGSPEC1;1S;PL;PRS	tur
N;LGSPEC1;1S;PL;PST	tur
N;LGSPEC1;1S;SG;LGSPEC2	tur
N;LGSPEC1;1S;SG;PRS	tur
N;LGSPEC1;1S;SG;PST	tur
N;LGSPEC1;2P;PL;LGSPEC2	tur
N;LGSPEC1;2P;PL;PRS	tur
N;LGSPEC1;2P;PL;PST	tur
N;LGSPEC1;2P;SG;LGSPEC2	tur
N;LGSPEC1;2P;SG;PRS	tur
N;LGSPEC1;2P;SG;PST	tur
N;LGSPEC1;2S;PL;LGSPEC2	tur
N;LGSPEC1;2S;PL;PRS	tur
N;LGSPEC1;2S;PL;PST	tur
N;LGSPEC1;2S;SG;LGSPEC2	tur
N;LGSPEC1;2S;SG;PRS	tur
N;LGSPEC1;2S;SG;PST	tur
N;LGSPEC1;3P;PL;LGSPEC2	tur
N;LGSPEC1;3P;PL;PRS	tur
N;LGSPEC1;3P;PL;PST	tur
N;LGSPEC1;3P;SG;LGSPEC2	tur
N;LGSPEC1;3P;SG;PRS	tur
N;LGSPEC1;3P;SG;PST	tur
N;LGSPEC1;3S;PL;LGSPEC2	tur
N;LGSPEC1;3S;PL;PRS	tur
N;LGSPEC1;3S;PL;PST	tur
N;LGSPEC1;3S;SG;LGSPEC2	tur
N;LGSPEC1;3S;SG;PRS	tur
N;LGSPEC1;3S;SG;PST	tur
N;LOC;PL	lav, lit, tur
N;LOC;PL;PSS1P	tur
N;LOC;PL;PSS2P	tur
N;LOC;PL;PSS2S	tur
N;LOC;PL;PSS3P	tur
N;LOC;PL;PSS3S	tur
N;LOC;SG	lav, lit, tur
N;LOC;SG;PSS1P	tur
N;LOC;SG;PSS2P	tur
N;LOC;SG;PSS2S	tur
N;LOC;SG;PSS3P	tur
N;LOC;SG;PSS3S	tur
N;NDEF;PL	nno, nob
N;NOM/ACC;PL;DEF	ron
N;NOM/ACC;SG;INDF	ron
N;NOM;ANIM;PL	ces
N;NOM;ANIM;SG	ces
N;NOM;DU	dsb, slv
N;NOM;INAN;PL	ces
N;NOM;INAN;SG	ces
N;NOM;PL	ces, deu, dsb, est, fin.1, fin.2, gle, hun, lat, lav, lit, pol, que, slv, sme, tur
N;NOM;PL;DEF	gle, sqi
N;NOM;PL;NDEF	sqi
N;NOM;PL;PSS1P	tur
N;NOM;PL;PSS2P	tur
N;NOM;PL;PSS2S	tur
N;NOM;PL;PSS3P	tur
N;NOM;PL;PSS3S	tur
N;NOM;SG	ces, deu, dsb, est, fin.1, fin.2, gle, hun, lat, lav, lit, pol, que, slv, sme, tur
N;NOM;SG;DEF	gle, sqi
N;NOM;SG;NDEF	sqi
N;NOM;SG;PSS1P	tur
N;NOM;SG;PSS2P	tur
N;NOM;SG;PSS2S	tur
N;NOM;SG;PSS3P	tur
N;NOM;SG;PSS3S	tur
N;NUM	kmr
N;ON+ABL;PL	hun
N;ON+ABL;SG	hun
N;ON+ALL;PL	hun
N;ON+ALL;SG	hun
N;ON+ESS;PL	hun
N;ON+ESS;SG	hun
N;PRIV;PL	est, fin.1, fin.2, que
N;PRIV;SG	est, fin.1, fin.2, que
N;PROX	ckb
N;PRP;PL	hun, sme
N;PRP;SG	hun, sme
N;PRT;PL	est, fin.1, fin.2
N;PRT;SG	est, fin.1, fin.2
N;PSS0	nav
N;PSS1D	nav
N;PSS1P	ckb
N;PSS1PE;ABL;PL	que
N;PSS1PE;ABL;SG	que
N;PSS1PE;ACC;PL	que
N;PSS1PE;ACC;SG	que
N;PSS1PE;BEN;PSS1PE;PL	que
N;PSS1PE;BEN;PSS1PE;SG	que
N;PSS1PE;CAUSV;PL	que
N;PSS1PE;CAUSV;SG	que
N;PSS1PE;COM;PL	que
N;PSS1PE;COM;SG	que
N;PSS1PE;COMPV;PL	que
N;PSS1PE;COMPV;SG	que
N;PSS1PE;DAT;PL	que
N;PSS1PE;DAT;SG	que
N;PSS1PE;DISTR;PL	que
N;PSS1PE;DISTR;SG	que
N;PSS1PE;ESS;PL	que
N;PSS1PE;ESS;SG	que
N;PSS1PE;EXCLV;PL	que
N;PSS1PE;EXCLV;SG	que
N;PSS1PE;GEN;PSS1PE;PL	que
N;PSS1PE;GEN;PSS1PE;SG	que
N;PSS1PE;INS;PL	que
N;PSS1PE;INS;SG	que
N;PSS1PE;INTER;PL	que
N;PSS1PE;INTER;SG	que
N;PSS1PE;NOM;PL	que
N;PSS1PE;NOM;SG	que
N;PSS1PE;PRIV;PL	que
N;PSS1PE;PRIV;SG	que
N;PSS1PE;TERM;PL	que
N;PSS1PE;TERM;SG	que
N;PSS1PI;ABL;PL	que
N;PSS1PI;ABL;SG	que
N;PSS1PI;ACC;PL	que
N;PSS1PI;ACC;SG	que
N;PSS1PI;BEN;PSS1PI;PL	que
N;PSS1PI;BEN;PSS1PI;SG	que
N;PSS1PI;CAUSV;PL	que
N;PSS1PI;CAUSV;SG	que
N;PSS1PI;COM;PL	que
N;PSS1PI;COM;SG	que
N;PSS1PI;COMPV;PL	que
N;PSS1PI;COMPV;SG	que
N;PSS1PI;DAT;PL	que
N;PSS1PI;DAT;SG	que
N;PSS1PI;DISTR;PL	que
N;PSS1PI;DISTR;SG	que
N;PSS1PI;ESS;PL	que
N;PSS1PI;ESS;SG	que
N;PSS1PI;EXCLV;PL	que
N;PSS1PI;EXCLV;SG	que
N;PSS1PI;GEN;PSS1PI;PL	que
N;PSS1PI;GEN;PSS1PI;SG	que
N;PSS1PI;INS;PL	que
N;PSS1PI;INS;SG	que
N;PSS1PI;INTER;PL	que
N;PSS1PI;INTER;SG	que
N;PSS1PI;NOM;PL	que
N;PSS1PI;NOM;SG	que
N;PSS1PI;PRIV;PL	que
N;PSS1PI;PRIV;SG	que
N;PSS1PI;TERM;PL	que
N;PSS1PI;TERM;SG	que
N;PSS1S	ckb, nav
N;PSS1S;ABL;PL	que
N;PSS1S;ABL;SG	que
N;PSS1S;ACC;PL	que
N;PSS1S;ACC;SG	que
N;PSS1S;BEN;PSS1S;PL	que
N;PSS1S;BEN;PSS1S;SG	que
N;PSS1S;CAUSV;PL	que
N;PSS1S;CAUSV;SG	que
N;PSS1S;COM;PL	que
N;PSS1S;COM;SG	que
N;PSS1S;COMPV;PL	que
N;PSS1S;COMPV;SG	que
N;PSS1S;DAT;PL	que
N;PSS1S;DAT;SG	que
N;PSS1S;DISTR;PL	que
N;PSS1S;DISTR;SG	que
N;PSS1S;ESS;PL	que
N;PSS1S;ESS;SG	que
N;PSS1S;EXCLV;PL	que
N;PSS1S;EXCLV;SG	que
N;PSS1S;GEN;PSS1S;PL	que
N;PSS1S;GEN;PSS1S;SG	que
N;PSS1S;INS;PL	que
N;PSS1S;INS;SG	que
N;PSS1S;INTER;PL	que
N;PSS1S;INTER;SG	que
N;PSS1S;NOM;PL	que
N;PSS1S;NOM;SG	que
N;PSS1S;PRIV;PL	que
N;PSS1S;PRIV;SG	que
N;PSS1S;TERM;PL	que
N;PSS1S;TERM;SG	que
N;PSS2D	nav
N;PSS2P	ckb
N;PSS2P;ABL;PL	que
N;PSS2P;ABL;SG	que
N;PSS2P;ACC;PL	que
N;PSS2P;ACC;SG	que
N;PSS2P;BEN;PSS2P;PL	que
N;PSS2P;BEN;PSS2P;SG	que
N;PSS2P;CAUSV;PL	que
N;PSS2P;CAUSV;SG	que
N;PSS2P;COM;PL	que
N;PSS2P;COM;SG	que
N;PSS2P;COMPV;PL	que
N;PSS2P;COMPV;SG	que
N;PSS2P;DAT;PL	que
N;PSS2P;DAT;SG	que
N;PSS2P;DISTR;PL	que
N;PSS2P;DISTR;SG	que
N;PSS2P;ESS;PL	que
N;PSS2P;ESS;SG	que
N;PSS2P;EXCLV;PL	que
N;PSS2P;EXCLV;SG	que
N;PSS2P;GEN;PSS2P;PL	que
N;PSS2P;GEN;PSS2P;SG	que
N;PSS2P;INS;PL	que
N;PSS2P;INS;SG	que
N;PSS2P;INTER;PL	que
N;PSS2P;INTER;SG	que
N;PSS2P;NOM;PL	que
N;PSS2P;NOM;SG	que
N;PSS2P;PRIV;PL	que
N;PSS2P;PRIV;SG	que
N;PSS2P;TERM;PL	que
N;PSS2P;TERM;SG	que
N;PSS2S	ckb, nav
N;PSS2S;ABL;PL	que
N;PSS2S;ABL;SG	que
N;PSS2S;ACC;PL	que
N;PSS2S;ACC;SG	que
N;PSS2S;BEN;PSS2S;PL	que
N;PSS2S;BEN;PSS2S;SG	que
N;PSS2S;CAUSV;PL	que
N;PSS2S;CAUSV;SG	que
N;PSS2S;COM;PL	que
N;PSS2S;COM;SG	que
N;PSS2S;COMPV;PL	que
N;PSS2S;COMPV;SG	que
N;PSS2S;DAT;PL	que
N;PSS2S;DAT;SG	que
N;PSS2S;DISTR;PL	que
N;PSS2S;DISTR;SG	que
N;PSS2S;ESS;PL	que
N;PSS2S;ESS;SG	que
N;PSS2S;EXCLV;PL	que
N;PSS2S;EXCLV;SG	que
N;PSS2S;GEN;PSS2S;PL	que
N;PSS2S;GEN;PSS2S;SG	que
N;PSS2S;INS;PL	que
N;PSS2S;INS;SG	que
N;PSS2S;INTER;PL	que
N;PSS2S;INTER;SG	que
N;PSS2S;NOM;PL	que
N;PSS2S;NOM;SG	que
N;PSS2S;PRIV;PL	que
N;PSS2S;PRIV;SG	que
N;PSS2S;TERM;PL	que
N;PSS2S;TERM;SG	que
N;PSS3	nav
N;PSS3P	ckb
N;PSS3P;ABL;PL	que
N;PSS3P;ABL;SG	que
N;PSS3P;ACC;PL	que
N;PSS3P;ACC;SG	que
N;PSS3P;BEN;PSS3P;PL	que
N;PSS3P;BEN;PSS3P;SG	que
N;PSS3P;CAUSV;PL	que
N;PSS3P;CAUSV;SG	que
N;PSS3P;COM;PL	que
N;PSS3P;COM;SG	que
N;PSS3P;COMPV;PL	que
N;PSS3P;COMPV;SG	que
N;PSS3P;DAT;PL	que
N;PSS3P;DAT;SG	que
N;PSS3P;DISTR;PL	que
N;PSS3P;DISTR;SG	que
N;PSS3P;ESS;PL	que
N;PSS3P;ESS;SG	que
N;PSS3P;EXCLV;PL	que
N;PSS3P;EXCLV;SG	que
N;PSS3P;GEN;PSS3P;PL	que
N;PSS3P;GEN;PSS3P;SG	que
N;PSS3P;INS;PL	que
N;PSS3P;INS;SG	que
N;PSS3P;INTER;PL	que
N;PSS3P;INTER;SG	que
N;PSS3P;NOM;PL	que
N;PSS3P;NOM;SG	que
N;PSS3P;PRIV;PL	que
N;PSS3P;PRIV;SG	que
N;PSS3P;TERM;PL	que
N;PSS3P;TERM;SG	que
N;PSS3S;ABL;PL	que
N;PSS3S;ABL;SG	que
N;PSS3S;ACC;PL	que
N;PSS3S;ACC;SG	que
N;PSS3S;BEN;PSS3S;PL	que
N;PSS3S;BEN;PSS3S;SG	que
N;PSS3S;CAUSV;PL	que
N;PSS3S;CAUSV;SG	que
N;PSS3S;COM;PL	que
N;PSS3S;COM;SG	que
N;PSS3S;COMPV;PL	que
N;PSS3S;COMPV;SG	que
N;PSS3S;DAT;PL	que
N;PSS3S;DAT;SG	que
N;PSS3S;DISTR;PL	que
N;PSS3S;DISTR;SG	que
N;PSS3S;ESS;PL	que
N;PSS3S;ESS;SG	que
N;PSS3S;EXCLV;PL	que
N;PSS3S;EXCLV;SG	que
N;PSS3S;GEN;PSS3S;PL	que
N;PSS3S;GEN;PSS3S;SG	que
N;PSS3S;INS;PL	que
N;PSS3S;INS;SG	que
N;PSS3S;INTER;PL	que
N;PSS3S;INTER;SG	que
N;PSS3S;NOM;PL	que
N;PSS3S;NOM;SG	que
N;PSS3S;PRIV;PL	que
N;PSS3S;PRIV;SG	que
N;PSS3S;TERM;PL	que
N;PSS3S;TERM;SG	que
N;PSS4	nav
N;PSS4;ARGAC3S	nav
N;REMT	ckb
N;SG;DEF	nno
N;TERM;PL	est, hun, que
N;TERM;SG	est, hun, que
N;TRANS;PL	est, fin.1, fin.2, hun
N;TRANS;SG	est, fin.1, fin.2, hun
N;VOC;ANIM;PL	ces
N;VOC;ANIM;SG	ces
N;VOC;INAN;PL	ces
N;VOC;INAN;SG	ces
N;VOC;PL	ces, gle, lat, lav, lit, pol, ron
N;VOC;SG	ces, gle, lat, lav, lit, pol, ron
NEG;PST;V;V.PTCP	ckb
NEG;V;V.MSDR;ACC	kmr
NFIN;V	ckb
PASS;PST;V;V.PTCP	ckb
PSS1P	nav
PSS2P	nav
PST;V;V.PTCP	ckb
V.CVB	ces, fao, hun, isl, pol
V.CVB;ACT	swe
V.CVB;ACT;PRS	slv
V.CVB;PASS	swe
V.CVB;PRS	fra, ita, ron, spa
V.CVB;PRS;FEM;SG	ces
V.CVB;PRS;MASC;SG	ces
V.CVB;PRS;PL	ces
V.CVB;PST	pol
V.CVB;PST;FEM;SG	ces
V.CVB;PST;MASC;SG	ces
V.CVB;PST;PL	ces
V.MSDR	pol, slv
V.PCTP;ACT;PRS	slv
V.PCTP;ACT;PST	slv
V.PCTP;PASS;PST	slv
V.PTCP	ces
V.PTCP.PRS	fao
V.PTCP.PST	fao
V.PTCP;ACT;PRF;ANIM;MASC;PL	ces
V.PTCP;ACT;PRF;FEM;PL	ces
V.PTCP;ACT;PRF;FEM;SG	ces
V.PTCP;ACT;PRF;INAN;MASC;PL	ces
V.PTCP;ACT;PRF;MASC;SG	ces
V.PTCP;ACT;PRF;NEUT;PL	ces
V.PTCP;ACT;PRF;NEUT;SG	ces
V.PTCP;ACT;PRS	dan, est, fin.1, fin.2
V.PTCP;ACT;PST	est, fin.1, fin.2
V.PTCP;FEM;PL;PST	por
V.PTCP;FEM;SG;PST	por
V.PTCP;FUT	hun, que
V.PTCP;MASC;PL;PST	por
V.PTCP;MASC;SG;PST	por
V.PTCP;PASS;ANIM;MASC;PL	ces
V.PTCP;PASS;FEM;PL	ces
V.PTCP;PASS;FEM;SG	ces
V.PTCP;PASS;INAN;MASC;PL	ces
V.PTCP;PASS;MASC;SG	ces
V.PTCP;PASS;NEUT;PL	ces
V.PTCP;PASS;NEUT;SG	ces
V.PTCP;PASS;PRS	est, fin.1, fin.2
V.PTCP;PASS;PST	dan, est, fin.1, fin.2
V.PTCP;PRS	cat, deu, fra, hun, isl, ita, lat, por, que, swe
V.PTCP;PST	deu, fra, hun, ita, nld, que, ron, swe
V.PTCP;PST;ACT;PL	pol
V.PTCP;PST;ACT;PL;MASC;HUM	pol
V.PTCP;PST;ACT;SG;FEM	pol
V.PTCP;PST;ACT;SG;MASC	pol
V.PTCP;PST;ACT;SG;NEUT	pol
V.PTCP;PST;FEM;PL	spa
V.PTCP;PST;FEM;SG	spa
V.PTCP;PST;MASC;PL	spa
V.PTCP;PST;MASC;SG	spa
V.PTCP;PST;PASS	pol
V.PTCP;PST;PASS;PL	pol
V.PTCP;PST;PASS;PL;MASC;HUM	pol
V.PTCP;PST;PASS;SG;FEM	pol
V.PTCP;PST;PASS;SG;MASC	pol
V.PTCP;PST;PASS;SG;NEUT	pol
V.PTCP;PST;PL;FEM	cat
V.PTCP;PST;PL;MASC	cat
V.PTCP;PST;SG;FEM	cat
V.PTCP;PST;SG;MASC	cat
V;1;PL;ADM;IPFV	sqi
V;1;PL;ADM;PRF	sqi
V;1;PL;ADM;PRF;PST	sqi
V;1;PL;ADM;PRS	sqi
V;1;PL;COND	gle, por
V;1;PL;COND;PRF	sqi
V;1;PL;COND;PRS	sqi
V;1;PL;FUT;IND	gle, lav, lit
V;1;PL;IMP	gle, lav, lit
V;1;PL;IMP;NEG	por
V;1;PL;IMP;POS	por
V;1;PL;IND;FUT	por, sqi
V;1;PL;IND;IPFV	sqi
V;1;PL;IND;PRF	sqi
V;1;PL;IND;PRF;FUT	sqi
V;1;PL;IND;PRF;PST	sqi
V;1;PL;IND;PRS	por, sqi
V;1;PL;IND;PST	sqi
V;1;PL;IND;PST;IPFV	por
V;1;PL;IND;PST;PFV	por
V;1;PL;IND;PST;PRF	por
V;1;PL;NFIN	por
V;1;PL;OPT;PRF	sqi
V;1;PL;OPT;PRS	sqi
V;1;PL;PRS;IND	gle, lav, lit
V;1;PL;PST;FREQ;IND	lit
V;1;PL;PST;HAB;IND	gle
V;1;PL;PST;IND	gle, lav, lit
V;1;PL;SBJV	lit
V;1;PL;SBJV;FUT	por
V;1;PL;SBJV;PRF	sqi
V;1;PL;SBJV;PRF;PST	sqi
V;1;PL;SBJV;PRS	gle, por, sqi
V;1;PL;SBJV;PST	gle, sqi
V;1;PL;SBJV;PST;IPFV	por
V;1;SG;ADM;IPFV	sqi
V;1;SG;ADM;PRF	sqi
V;1;SG;ADM;PRF;PST	sqi
V;1;SG;ADM;PRS	sqi
V;1;SG;COND	gle, por
V;1;SG;COND;PRF	sqi
V;1;SG;COND;PRS	sqi
V;1;SG;FUT;IND	gle, lav, lit
V;1;SG;IMP	gle
V;1;SG;IND;FUT	por, sqi
V;1;SG;IND;IPFV	sqi
V;1;SG;IND;PRF	sqi
V;1;SG;IND;PRF;FUT	sqi
V;1;SG;IND;PRF;PST	sqi
V;1;SG;IND;PRS	por, sqi
V;1;SG;IND;PST	sqi
V;1;SG;IND;PST;IPFV	por
V;1;SG;IND;PST;PFV	por
V;1;SG;IND;PST;PRF	por
V;1;SG;NFIN	por
V;1;SG;OPT;PRF	sqi
V;1;SG;OPT;PRS	sqi
V;1;SG;PRS;IND	gle, lav, lit
V;1;SG;PST;FREQ;IND	lit
V;1;SG;PST;HAB;IND	gle
V;1;SG;PST;IND	gle, lav, lit
V;1;SG;SBJV	lit
V;1;SG;SBJV;FUT	por
V;1;SG;SBJV;PRF	sqi
V;1;SG;SBJV;PRF;PST	sqi
V;1;SG;SBJV;PRS	gle, por, sqi
V;1;SG;SBJV;PST	gle, sqi
V;1;SG;SBJV;PST;IPFV	por
V;2:SG;SBJV;PRS	gle
V;2:SG;SBJV;PST	gle
V;2;PL;ADM;IPFV	sqi
V;2;PL;ADM;PRF	sqi
V;2;PL;ADM;PRF;PRF	sqi
V;2;PL;ADM;PRS	sqi
V;2;PL;COND	gle, por
V;2;PL;COND;PRF	sqi
V;2;PL;COND;PRS	sqi
V;2;PL;FUT;IND	gle, lav, lit
V;2;PL;IMP	gle, lav, lit, sqi
V;2;PL;IMP;NEG	por
V;2;PL;IMP;POS	por
V;2;PL;IND;FUT	por, sqi
V;2;PL;IND;IPFV	sqi
V;2;PL;IND;PRF	sqi
V;2;PL;IND;PRF;FUT	sqi
V;2;PL;IND;PRF;PRF	sqi
V;2;PL;IND;PRS	por, sqi
V;2;PL;IND;PST	sqi
V;2;PL;IND;PST;IPFV	por
V;2;PL;IND;PST;PFV	por
V;2;PL;IND;PST;PRF	por
V;2;PL;NFIN	por
V;2;PL;OPT;PRF	sqi
V;2;PL;OPT;PRS	sqi
V;2;PL;PRS;IND	gle, lav, lit
V;2;PL;PST;FREQ;IND	lit
V;2;PL;PST;HAB;IND	gle
V;2;PL;PST;IND	gle, lav, lit
V;2;PL;SBJV	lit
V;2;PL;SBJV;FUT	por
V;2;PL;SBJV;PRF	sqi
V;2;PL;SBJV;PRF;PRF	sqi
V;2;PL;SBJV;PRS	gle, por, sqi
V;2;PL;SBJV;PST	gle, sqi
V;2;PL;SBJV;PST;IPFV	por
V;2;SG;ADM;IPFV	sqi
V;2;SG;ADM;PRF	sqi
V;2;SG;ADM;PRF;PST	sqi
V;2;SG;ADM;PRS	sqi
V;2;SG;COND	gle, por
V;2;SG;COND;PRF	sqi
V;2;SG;COND;PRS	sqi
V;2;SG;FUT;IND	gle, lav, lit
V;2;SG;IMP	gle, lav, lit, sqi
V;2;SG;IMP;NEG	por
V;2;SG;IMP;POS	por
V;2;SG;IND;FUT	por, sqi
V;2;SG;IND;IPFV	sqi
V;2;SG;IND;PRF	sqi
V;2;SG;IND;PRF;FUT	sqi
V;2;SG;IND;PRF;PST	sqi
V;2;SG;IND;PRS	por, sqi
V;2;SG;IND;PST	sqi
V;2;SG;IND;PST;IPFV	por
V;2;SG;IND;PST;PFV	por
V;2;SG;IND;PST;PRF	por
V;2;SG;NFIN	por
V;2;SG;OPT;PRF	sqi
V;2;SG;OPT;PRS	sqi
V;2;SG;PRS;IND	gle, lav, lit
V;2;SG;PST;FREQ;IND	lit
V;2;SG;PST;HAB;IND	gle
V;2;SG;PST;IND	gle, lav, lit
V;2;SG;SBJV	lit
V;2;SG;SBJV;FUT	por
V;2;SG;SBJV;PRF	sqi
V;2;SG;SBJV;PRF;PST	sqi
V;2;SG;SBJV;PRS	por, sqi
V;2;SG;SBJV;PST	sqi
V;2;SG;SBJV;PST;IPFV	por
V;3;PL;ADM;IPFV	sqi
V;3;PL;ADM;PRF	sqi
V;3;PL;ADM;PRF;PST	sqi
V;3;PL;ADM;PRS	sqi
V;3;PL;COND	gle, por
V;3;PL;COND;PRF	sqi
V;3;PL;COND;PRS	sqi
V;3;PL;DRCT;PST	hai
V;3;PL;DRCT;PST;HAB	hai
V;3;PL;DUR	hai
V;3;PL;FUT;IND	gle, lav, lit
V;3;PL;FUT;LGSPEC6	hai
V;3;PL;FUT;REFL;INT	hai
V;3;PL;IMMED;FUT	hai
V;3;PL;IMMED;PRS	hai
V;3;PL;IMP	gle, lav, lit
V;3;PL;IMP;NEG	por
V;3;PL;IMP;POS	por
V;3;PL;IND;FUT	por, sqi
V;3;PL;IND;IPFV	sqi
V;3;PL;IND;PRF	sqi
V;3;PL;IND;PRF;FUT	sqi
V;3;PL;IND;PRF;PST	sqi
V;3;PL;IND;PRS	por, sqi
V;3;PL;IND;PST	sqi
V;3;PL;IND;PST;IPFV	por
V;3;PL;IND;PST;PFV	por
V;3;PL;IND;PST;PRF	por
V;3;PL;INT;FUT;LGSPEC8	hai
V;3;PL;INT;FUT;REMT	hai
V;3;PL;INT;LGSPEC8;PRS	hai
V;3;PL;INT;MED;FUT	hai
V;3;PL;INT;PROX;FUT	hai
V;3;PL;INT;PRS;HAB	hai
V;3;PL;INT;PST	hai
V;3;PL;INT;PST;HAB	hai
V;3;PL;IRR;PRS	hai
V;3;PL;LGSPEC1;IMMED;PRS	hai
V;3;PL;LGSPEC1;INT;FUT	hai
V;3;PL;LGSPEC1;INT;PRS	hai
V;3;PL;LGSPEC1;INT;PST	hai
V;3;PL;LGSPEC1;INT;PST;HAB	hai
V;3;PL;LGSPEC1;LGSPEC8;PRS	hai
V;3;PL;LGSPEC2;FUT	hai
V;3;PL;LGSPEC2;PRS	hai
V;3;PL;LGSPEC2;PST	hai
V;3;PL;LGSPEC2;PST;HAB	hai
V;3;PL;LGSPEC2;REL	hai
V;3;PL;LGSPEC4;PST	hai
V;3;PL;LGSPEC4;PST;HAB	hai
V;3;PL;LGSPEC5;PST	hai
V;3;PL;LGSPEC6	hai
V;3;PL;LGSPEC7	hai
V;3;PL;LGSPEC8;FUT	hai
V;3;PL;LGSPEC8;PRS	hai
V;3;PL;LGSPEC9;MED;FUT	hai
V;3;PL;MED;FUT	hai
V;3;PL;NFIN	por
V;3;PL;OPT;PRF	sqi
V;3;PL;OPT;PRS	sqi
V;3;PL;PROX;FUT	hai
V;3;PL;PRS;HAB	hai
V;3;PL;PRS;HAB;LGSPEC6	hai
V;3;PL;PRS;IND	gle, lav, lit
V;3;PL;PST;FREQ;IND	lit
V;3;PL;PST;HAB;IND	gle
V;3;PL;PST;IND	gle, lav, lit
V;3;PL;PST;LGSPEC6	hai
V;3;PL;REFL	hai
V;3;PL;REL	hai
V;3;PL;REL;FUT	hai
V;3;PL;REL;LGSPEC3	hai
V;3;PL;SBJV	lit
V;3;PL;SBJV;FUT	por
V;3;PL;SBJV;PRF	sqi
V;3;PL;SBJV;PRF;PST	sqi
V;3;PL;SBJV;PRS	gle, por, sqi
V;3;PL;SBJV;PST	gle, sqi
V;3;PL;SBJV;PST;IPFV	por
V;3;SG;ADM;IPFV	sqi
V;3;SG;ADM;PRF	sqi
V;3;SG;ADM;PRF;PST	sqi
V;3;SG;ADM;PRS	sqi
V;3;SG;COND	gle, por
V;3;SG;COND;PRF	sqi
V;3;SG;COND;PRS	sqi
V;3;SG;FUT;IND	gle, lav, lit
V;3;SG;IMP	gle, lav, lit
V;3;SG;IMP;NEG	por
V;3;SG;IMP;POS	por
V;3;SG;IND;FUT	por, sqi
V;3;SG;IND;IPFV	sqi
V;3;SG;IND;PRF	sqi
V;3;SG;IND;PRF;FUT	sqi
V;3;SG;IND;PRF;PST	sqi
V;3;SG;IND;PRS	por, sqi
V;3;SG;IND;PST	sqi
V;3;SG;IND;PST;IPFV	por
V;3;SG;IND;PST;PFV	por
V;3;SG;IND;PST;PRF	por
V;3;SG;NFIN	por
V;3;SG;OPT;PRF	sqi
V;3;SG;OPT;PRS	sqi
V;3;SG;PRS	eng
V;3;SG;PRS;IND	gle, lav, lit
V;3;SG;PST;FREQ;IND	lit
V;3;SG;PST;HAB;IND	gle
V;3;SG;PST;IND	gle, lav, lit
V;3;SG;SBJV	lit
V;3;SG;SBJV;FUT	por
V;3;SG;SBJV;PRF	sqi
V;3;SG;SBJV;PRF;PST	sqi
V;3;SG;SBJV;PRS	gle, por, sqi
V;3;SG;SBJV;PST	gle, sqi
V;3;SG;SBJV;PST;IPFV	por
V;ACT;IMP	dan
V;ACT;IND;PRS	dan, swe
V;ACT;IND;PST	dan, swe
V;ACT;NFIN	dan, swe
V;ACT;PRS;NEG;COND;1;PL	fin.1, fin.2
V;ACT;PRS;NEG;COND;1;SG	fin.1, fin.2
V;ACT;PRS;NEG;COND;2;PL	fin.1, fin.2
V;ACT;PRS;NEG;COND;2;SG	fin.1, fin.2
V;ACT;PRS;NEG;COND;3;PL	fin.1, fin.2
V;ACT;PRS;NEG;COND;3;SG	fin.1, fin.2
V;ACT;PRS;NEG;IMP;1;PL	est, fin.1, fin.2
V;ACT;PRS;NEG;IMP;2;PL	est, fin.1, fin.2
V;ACT;PRS;NEG;IMP;2;SG	est, fin.1, fin.2
V;ACT;PRS;NEG;IMP;3;PL	est, fin.1, fin.2
V;ACT;PRS;NEG;IMP;3;SG	est, fin.1, fin.2
V;ACT;PRS;NEG;IND	est
V;ACT;PRS;NEG;IND;1;PL	fin.1, fin.2
V;ACT;PRS;NEG;IND;1;SG	fin.1, fin.2
V;ACT;PRS;NEG;IND;2;PL	fin.1, fin.2
V;ACT;PRS;NEG;IND;2;SG	fin.1, fin.2
V;ACT;PRS;NEG;IND;3;PL	fin.1, fin.2
V;ACT;PRS;NEG;IND;3;SG	fin.1, fin.2
V;ACT;PRS;NEG;POT;1;PL	fin.1, fin.2
V;ACT;PRS;NEG;POT;1;SG	fin.1, fin.2
V;ACT;PRS;NEG;POT;2;PL	fin.1, fin.2
V;ACT;PRS;NEG;POT;2;SG	fin.1, fin.2
V;ACT;PRS;NEG;POT;3;PL	fin.1, fin.2
V;ACT;PRS;NEG;POT;3;SG	fin.1, fin.2
V;ACT;PRS;NEG;QUOT	est
V;ACT;PRS;POS;COND;1;PL	est, fin.1, fin.2
V;ACT;PRS;POS;COND;1;SG	est, fin.1, fin.2
V;ACT;PRS;POS;COND;2;PL	est, fin.1, fin.2
V;ACT;PRS;POS;COND;2;SG	est, fin.1, fin.2
V;ACT;PRS;POS;COND;3;PL	est, fin.1, fin.2
V;ACT;PRS;POS;COND;3;SG	est, fin.1, fin.2
V;ACT;PRS;POS;IMP;1;PL	est, fin.1, fin.2
V;ACT;PRS;POS;IMP;2;PL	est, fin.1, fin.2
V;ACT;PRS;POS;IMP;2;SG	est, fin.1, fin.2
V;ACT;PRS;POS;IMP;3;PL	est, fin.1, fin.2
V;ACT;PRS;POS;IMP;3;SG	est, fin.1, fin.2
V;ACT;PRS;POS;IND;1;PL	est, fin.1, fin.2
V;ACT;PRS;POS;IND;1;SG	est, fin.1, fin.2
V;ACT;PRS;POS;IND;2;PL	est, fin.1, fin.2
V;ACT;PRS;POS;IND;2;SG	est, fin.1, fin.2
V;ACT;PRS;POS;IND;3;PL	est, fin.1, fin.2
V;ACT;PRS;POS;IND;3;SG	est, fin.1, fin.2
V;ACT;PRS;POS;POT;1;PL	fin.1, fin.2
V;ACT;PRS;POS;POT;1;SG	fin.1, fin.2
V;ACT;PRS;POS;POT;2;PL	fin.1, fin.2
V;ACT;PRS;POS;POT;2;SG	fin.1, fin.2
V;ACT;PRS;POS;POT;3;PL	fin.1, fin.2
V;ACT;PRS;POS;POT;3;SG	fin.1, fin.2
V;ACT;PRS;POS;QUOT	est
V;ACT;PRS;PRF:POS;COND;2;PL	est
V;ACT;PRS;PRF;NEG;COND	est
V;ACT;PRS;PRF;NEG;COND;1;PL	fin.1, fin.2
V;ACT;PRS;PRF;NEG;COND;1;SG	fin.1, fin.2
V;ACT;PRS;PRF;NEG;COND;2;PL	fin.1, fin.2
V;ACT;PRS;PRF;NEG;COND;2;SG	fin.1, fin.2
V;ACT;PRS;PRF;NEG;COND;3;PL	fin.1, fin.2
V;ACT;PRS;PRF;NEG;COND;3;SG	fin.1, fin.2
V;ACT;PRS;PRF;NEG;IMP;1;PL	fin.1, fin.2
V;ACT;PRS;PRF;NEG;IMP;2;PL	fin.1, fin.2
V;ACT;PRS;PRF;NEG;IMP;2;SG	fin.1, fin.2
V;ACT;PRS;PRF;NEG;IMP;3;PL	fin.1, fin.2
V;ACT;PRS;PRF;NEG;IMP;3;SG	fin.1, fin.2
V;ACT;PRS;PRF;NEG;IMP;PL	est
V;ACT;PRS;PRF;NEG;IMP;SG	est
V;ACT;PRS;PRF;NEG;IND;1;PL	fin.1, fin.2
V;ACT;PRS;PRF;NEG;IND;1;SG	fin.1, fin.2
V;ACT;PRS;PRF;NEG;IND;2;PL	fin.1, fin.2
V;ACT;PRS;PRF;NEG;IND;2;SG	fin.1, fin.2
V;ACT;PRS;PRF;NEG;IND;3;PL	fin.1, fin.2
V;ACT;PRS;PRF;NEG;IND;3;SG	fin.1, fin.2
V;ACT;PRS;PRF;NEG;POT;1;PL	fin.1, fin.2
V;ACT;PRS;PRF;NEG;POT;1;SG	fin.1, fin.2
V;ACT;PRS;PRF;NEG;POT;2;PL	fin.1, fin.2
V;ACT;PRS;PRF;NEG;POT;2;SG	fin.1, fin.2
V;ACT;PRS;PRF;NEG;POT;3;PL	fin.1, fin.2
V;ACT;PRS;PRF;NEG;POT;3;SG	fin.1, fin.2
V;ACT;PRS;PRF;NEG;QUOT	est
V;ACT;PRS;PRF;POS;COND	est
V;ACT;PRS;PRF;POS;COND;1;PL	est, fin.1, fin.2
V;ACT;PRS;PRF;POS;COND;1;SG	est, fin.1, fin.2
V;ACT;PRS;PRF;POS;COND;2;PL	est, fin.1, fin.2
V;ACT;PRS;PRF;POS;COND;2;SG	est, fin.1, fin.2
V;ACT;PRS;PRF;POS;COND;3;PL	est, fin.1, fin.2
V;ACT;PRS;PRF;POS;COND;3;SG	est, fin.1, fin.2
V;ACT;PRS;PRF;POS;IMP;1;PL	fin.1, fin.2
V;ACT;PRS;PRF;POS;IMP;2;PL	fin.1, fin.2
V;ACT;PRS;PRF;POS;IMP;2;SG	fin.1, fin.2
V;ACT;PRS;PRF;POS;IMP;3;PL	fin.1, fin.2
V;ACT;PRS;PRF;POS;IMP;3;SG	fin.1, fin.2
V;ACT;PRS;PRF;POS;IMP;PL	est
V;ACT;PRS;PRF;POS;IMP;SG	est
V;ACT;PRS;PRF;POS;IND;1;PL	est, fin.1, fin.2
V;ACT;PRS;PRF;POS;IND;1;SG	est, fin.1, fin.2
V;ACT;PRS;PRF;POS;IND;2;PL	est, fin.1, fin.2
V;ACT;PRS;PRF;POS;IND;2;SG	est, fin.1, fin.2
V;ACT;PRS;PRF;POS;IND;3;PL	est, fin.1, fin.2
V;ACT;PRS;PRF;POS;IND;3;SG	est, fin.1, fin.2
V;ACT;PRS;PRF;POS;POT;1;PL	fin.1, fin.2
V;ACT;PRS;PRF;POS;POT;1;SG	fin.1, fin.2
V;ACT;PRS;PRF;POS;POT;2;PL	fin.1, fin.2
V;ACT;PRS;PRF;POS;POT;2;SG	fin.1, fin.2
V;ACT;PRS;PRF;POS;POT;3;PL	fin.1, fin.2
V;ACT;PRS;PRF;POS;POT;3;SG	fin.1, fin.2
V;ACT;PRS;PRF;POS;QUOT	est
V;ACT;PST;NEG;IND	est
V;ACT;PST;NEG;IND;1;PL	fin.1, fin.2
V;ACT;PST;NEG;IND;1;SG	fin.1, fin.2
V;ACT;PST;NEG;IND;2;PL	fin.1, fin.2
V;ACT;PST;NEG;IND;2;SG	fin.1, fin.2
V;ACT;PST;NEG;IND;3;PL	fin.1, fin.2
V;ACT;PST;NEG;IND;3;SG	fin.1, fin.2
V;ACT;PST;POS;IND;1;PL	est, fin.1, fin.2
V;ACT;PST;POS;IND;1;SG	est, fin.1, fin.2
V;ACT;PST;POS;IND;2;PL	est, fin.1, fin.2
V;ACT;PST;POS;IND;2;SG	est, fin.1, fin.2
V;ACT;PST;POS;IND;3;PL	est, fin.1, fin.2
V;ACT;PST;POS;IND;3;SG	est, fin.1, fin.2
V;ACT;PST;PRF;NEG;IND	est
V;ACT;PST;PRF;NEG;IND;1;PL	fin.1, fin.2
V;ACT;PST;PRF;NEG;IND;1;SG	fin.1, fin.2
V;ACT;PST;PRF;NEG;IND;2;PL	fin.1, fin.2
V;ACT;PST;PRF;NEG;IND;2;SG	fin.1, fin.2
V;ACT;PST;PRF;NEG;IND;3;PL	fin.1, fin.2
V;ACT;PST;PRF;NEG;IND;3;SG	fin.1, fin.2
V;ACT;PST;PRF;POS;IND;1;PL	fin.1, fin.2
V;ACT;PST;PRF;POS;IND;1;SG	fin.1, fin.2
V;ACT;PST;PRF;POS;IND;2;PL	fin.1, fin.2
V;ACT;PST;PRF;POS;IND;2;SG	fin.1, fin.2
V;ACT;PST;PRF;POS;IND;3;PL	fin.1, fin.2
V;ACT;PST;PRF;POS;IND;3;SG	fin.1, fin.2
V;ARGABS1;ARGABSPL;ARGERG2;ARGERGPL;PAST;POT	eus
V;ARGABS1;ARGABSPL;ARGERG2;ARGERGSG;ARGERGINFM;ARGERGMASC;PAST;POT	eus
V;ARGABS1;ARGABSPL;ARGERG2;ARGERGSG;PAST;POT	eus
V;ARGABS1;ARGABSPL;ARGERG3;ARGERGPL;HYP;IND	eus
V;ARGABS1;ARGABSPL;ARGERG3;ARGERGPL;HYP;POT	eus
V;ARGABS1;ARGABSPL;ARGERG3;ARGERGPL;INFM;FEM;HYP;POT	eus
V;ARGABS1;ARGABSPL;ARGERG3;ARGERGPL;INFM;FEM;PAST;IND	eus
V;ARGABS1;ARGABSPL;ARGERG3;ARGERGPL;INFM;FEM;PAST;POT	eus
V;ARGABS1;ARGABSPL;ARGERG3;ARGERGPL;INFM;FEM;PRES;IND	eus
V;ARGABS1;ARGABSPL;ARGERG3;ARGERGPL;INFM;FEM;PRES;POT	eus
V;ARGABS1;ARGABSPL;ARGERG3;ARGERGPL;INFM;MASC;HYP;POT	eus
V;ARGABS1;ARGABSPL;ARGERG3;ARGERGPL;INFM;MASC;PAST;IND	eus
V;ARGABS1;ARGABSPL;ARGERG3;ARGERGPL;INFM;MASC;PAST;POT	eus
V;ARGABS1;ARGABSPL;ARGERG3;ARGERGPL;INFM;MASC;PRES;IND	eus
V;ARGABS1;ARGABSPL;ARGERG3;ARGERGPL;INFM;MASC;PRES;POT	eus
V;ARGABS1;ARGABSPL;ARGERG3;ARGERGPL;PAST;IND	eus
V;ARGABS1;ARGABSPL;ARGERG3;ARGERGPL;PAST;POT	eus
V;ARGABS1;ARGABSPL;ARGERG3;ARGERGPL;PRES;IND	eus
V;ARGABS1;ARGABSPL;ARGERG3;ARGERGPL;PRES;POT	eus
V;ARGABS1;ARGABSPL;ARGERG3;ARGERGSG;PAST;POT	eus
V;ARGABS1;ARGABSPL;ARGIO2;ARGIOPL;HYP;IND	eus
V;ARGABS1;ARGABSPL;ARGIO2;ARGIOPL;HYP;POT	eus
V;ARGABS1;ARGABSPL;ARGIO2;ARGIOPL;PAST;IND	eus
V;ARGABS1;ARGABSPL;ARGIO2;ARGIOPL;PAST;POT	eus
V;ARGABS1;ARGABSPL;ARGIO2;ARGIOPL;PRES;IND	eus
V;ARGABS1;ARGABSPL;ARGIO2;ARGIOPL;PRES;POT	eus
V;ARGABS1;ARGABSPL;ARGIO2;ARGIOSG;ARGIOINFM;ARGIOFEM;HYP;IND	eus
V;ARGABS1;ARGABSPL;ARGIO2;ARGIOSG;ARGIOINFM;ARGIOFEM;HYP;POT	eus
V;ARGABS1;ARGABSPL;ARGIO2;ARGIOSG;ARGIOINFM;ARGIOFEM;PAST;IND	eus
V;ARGABS1;ARGABSPL;ARGIO2;ARGIOSG;ARGIOINFM;ARGIOFEM;PAST;POT	eus
V;ARGABS1;ARGABSPL;ARGIO2;ARGIOSG;ARGIOINFM;ARGIOFEM;PRES;IND	eus
V;ARGABS1;ARGABSPL;ARGIO2;ARGIOSG;ARGIOINFM;ARGIOFEM;PRES;POT	eus
V;ARGABS1;ARGABSPL;ARGIO2;ARGIOSG;ARGIOINFM;ARGIOMASC;HYP;IND	eus
V;ARGABS1;ARGABSPL;ARGIO2;ARGIOSG;ARGIOINFM;ARGIOMASC;HYP;POT	eus
V;ARGABS1;ARGABSPL;ARGIO2;ARGIOSG;ARGIOINFM;ARGIOMASC;PAST;IND	eus
V;ARGABS1;ARGABSPL;ARGIO2;ARGIOSG;ARGIOINFM;ARGIOMASC;PAST;POT	eus
V;ARGABS1;ARGABSPL;ARGIO2;ARGIOSG;ARGIOINFM;ARGIOMASC;PRES;IND	eus
V;ARGABS1;ARGABSPL;ARGIO2;ARGIOSG;ARGIOINFM;ARGIOMASC;PRES;POT	eus
V;ARGABS1;ARGABSPL;ARGIO2;ARGIOSG;HYP;IND	eus
V;ARGABS1;ARGABSPL;ARGIO2;ARGIOSG;HYP;POT	eus
V;ARGABS1;ARGABSPL;ARGIO2;ARGIOSG;PAST;IND	eus
V;ARGABS1;ARGABSPL;ARGIO2;ARGIOSG;PAST;POT	eus
V;ARGABS1;ARGABSPL;ARGIO2;ARGIOSG;PRES;IND	eus
V;ARGABS1;ARGABSPL;ARGIO2;ARGIOSG;PRES;POT	eus
V;ARGABS1;ARGABSPL;ARGIO3;ARGIOPL;HYP;IND	eus
V;ARGABS1;ARGABSPL;ARGIO3;ARGIOPL;HYP;POT	eus
V;ARGABS1;ARGABSPL;ARGIO3;ARGIOPL;INFM;FEM;PAST;IND	eus
V;ARGABS1;ARGABSPL;ARGIO3;ARGIOPL;INFM;FEM;PAST;POT	eus
V;ARGABS1;ARGABSPL;ARGIO3;ARGIOPL;INFM;FEM;PRES;IND	eus
V;ARGABS1;ARGABSPL;ARGIO3;ARGIOPL;INFM;FEM;PRES;POT	eus
V;ARGABS1;ARGABSPL;ARGIO3;ARGIOPL;INFM;MASC;PAST;IND	eus
V;ARGABS1;ARGABSPL;ARGIO3;ARGIOPL;INFM;MASC;PAST;POT	eus
V;ARGABS1;ARGABSPL;ARGIO3;ARGIOPL;INFM;MASC;PRES;IND	eus
V;ARGABS1;ARGABSPL;ARGIO3;ARGIOPL;INFM;MASC;PRES;POT	eus
V;ARGABS1;ARGABSPL;ARGIO3;ARGIOPL;PAST;IND	eus
V;ARGABS1;ARGABSPL;ARGIO3;ARGIOPL;PAST;POT	eus
V;ARGABS1;ARGABSPL;ARGIO3;ARGIOPL;PRES;IND	eus
V;ARGABS1;ARGABSPL;ARGIO3;ARGIOPL;PRES;POT	eus
V;ARGABS1;ARGABSPL;ARGIO3;ARGIOSG;HYP;IND	eus
V;ARGABS1;ARGABSPL;ARGIO3;ARGIOSG;HYP;POT	eus
V;ARGABS1;ARGABSPL;ARGIO3;ARGIOSG;INFM;FEM;PAST;IND	eus
V;ARGABS1;ARGABSPL;ARGIO3;ARGIOSG;INFM;FEM;PAST;POT	eus
V;ARGABS1;ARGABSPL;ARGIO3;ARGIOSG;INFM;FEM;PRES;IND	eus
V;ARGABS1;ARGABSPL;ARGIO3;ARGIOSG;INFM;FEM;PRES;POT	eus
V;ARGABS1;ARGABSPL;ARGIO3;ARGIOSG;INFM;MASC;PAST;IND	eus
V;ARGABS1;ARGABSPL;ARGIO3;ARGIOSG;INFM;MASC;PAST;POT	eus
V;ARGABS1;ARGABSPL;ARGIO3;ARGIOSG;INFM;MASC;PRES;IND	eus
V;ARGABS1;ARGABSPL;ARGIO3;ARGIOSG;INFM;MASC;PRES;POT	eus
V;ARGABS1;ARGABSPL;ARGIO3;ARGIOSG;PAST;IND	eus
V;ARGABS1;ARGABSPL;ARGIO3;ARGIOSG;PAST;POT	eus
V;ARGABS1;ARGABSPL;ARGIO3;ARGIOSG;PRES;IND	eus
V;ARGABS1;ARGABSPL;ARGIO3;ARGIOSG;PRES;POT	eus
V;ARGABS1;ARGABSPL;HYP;IND	eus
V;ARGABS1;ARGABSPL;HYP;POT	eus
V;ARGABS1;ARGABSPL;INFM;FEM;PAST;IND	eus
V;ARGABS1;ARGABSPL;INFM;FEM;PAST;POT	eus
V;ARGABS1;ARGABSPL;INFM;FEM;PRES;IND	eus
V;ARGABS1;ARGABSPL;INFM;FEM;PRES;POT	eus
V;ARGABS1;ARGABSPL;INFM;MASC;PAST;IND	eus
V;ARGABS1;ARGABSPL;INFM;MASC;PAST;POT	eus
V;ARGABS1;ARGABSPL;INFM;MASC;PRES;IND	eus
V;ARGABS1;ARGABSPL;INFM;MASC;PRES;POT	eus
V;ARGABS1;ARGABSPL;PAST;IND	eus
V;ARGABS1;ARGABSPL;PAST;POT	eus
V;ARGABS1;ARGABSPL;PRES;IND	eus
V;ARGABS1;ARGABSPL;PRES;POT	eus
V;ARGABS1;ARGABSSG;ARGERG3;ARGERGPL;HYP;IND	eus
V;ARGABS1;ARGABSSG;ARGERG3;ARGERGPL;HYP;POT	eus
V;ARGABS1;ARGABSSG;ARGERG3;ARGERGPL;INFM;FEM;HYP;POT	eus
V;ARGABS1;ARGABSSG;ARGERG3;ARGERGPL;INFM;FEM;PAST;IND	eus
V;ARGABS1;ARGABSSG;ARGERG3;ARGERGPL;INFM;FEM;PAST;POT	eus
V;ARGABS1;ARGABSSG;ARGERG3;ARGERGPL;INFM;FEM;PRES;IND	eus
V;ARGABS1;ARGABSSG;ARGERG3;ARGERGPL;INFM;MASC;HYP;POT	eus
V;ARGABS1;ARGABSSG;ARGERG3;ARGERGPL;INFM;MASC;PAST;IND	eus
V;ARGABS1;ARGABSSG;ARGERG3;ARGERGPL;INFM;MASC;PAST;POT	eus
V;ARGABS1;ARGABSSG;ARGERG3;ARGERGPL;INFM;MASC;PRES;IND	eus
V;ARGABS1;ARGABSSG;ARGERG3;ARGERGPL;PAST;IND	eus
V;ARGABS1;ARGABSSG;ARGERG3;ARGERGPL;PAST;POT	eus
V;ARGABS1;ARGABSSG;ARGERG3;ARGERGPL;PRES;IND	eus
V;ARGABS1;ARGABSSG;ARGIO2;ARGIOPL;HYP;IND	eus
V;ARGABS1;ARGABSSG;ARGIO2;ARGIOPL;HYP;POT	eus
V;ARGABS1;ARGABSSG;ARGIO2;ARGIOPL;PAST;IND	eus
V;ARGABS1;ARGABSSG;ARGIO2;ARGIOPL;PAST;POT	eus
V;ARGABS1;ARGABSSG;ARGIO2;ARGIOPL;PRES;IND	eus
V;ARGABS1;ARGABSSG;ARGIO2;ARGIOPL;PRES;POT	eus
V;ARGABS1;ARGABSSG;ARGIO2;ARGIOSG;ARGIOINFM;ARGIOFEM;HYP;IND	eus
V;ARGABS1;ARGABSSG;ARGIO2;ARGIOSG;ARGIOINFM;ARGIOFEM;HYP;POT	eus
V;ARGABS1;ARGABSSG;ARGIO2;ARGIOSG;ARGIOINFM;ARGIOFEM;PAST;IND	eus
V;ARGABS1;ARGABSSG;ARGIO2;ARGIOSG;ARGIOINFM;ARGIOFEM;PAST;POT	eus
V;ARGABS1;ARGABSSG;ARGIO2;ARGIOSG;ARGIOINFM;ARGIOFEM;PRES;IND	eus
V;ARGABS1;ARGABSSG;ARGIO2;ARGIOSG;ARGIOINFM;ARGIOFEM;PRES;POT	eus
V;ARGABS1;ARGABSSG;ARGIO2;ARGIOSG;ARGIOINFM;ARGIOMASC;HYP;IND	eus
V;ARGABS1;ARGABSSG;ARGIO2;ARGIOSG;ARGIOINFM;ARGIOMASC;HYP;POT	eus
V;ARGABS1;ARGABSSG;ARGIO2;ARGIOSG;ARGIOINFM;ARGIOMASC;PAST;IND	eus
V;ARGABS1;ARGABSSG;ARGIO2;ARGIOSG;ARGIOINFM;ARGIOMASC;PAST;POT	eus
V;ARGABS1;ARGABSSG;ARGIO2;ARGIOSG;ARGIOINFM;ARGIOMASC;PRES;IND	eus
V;ARGABS1;ARGABSSG;ARGIO2;ARGIOSG;ARGIOINFM;ARGIOMASC;PRES;POT	eus
V;ARGABS1;ARGABSSG;ARGIO2;ARGIOSG;HYP;IND	eus
V;ARGABS1;ARGABSSG;ARGIO2;ARGIOSG;HYP;POT	eus
V;ARGABS1;ARGABSSG;ARGIO2;ARGIOSG;PAST;IND	eus
V;ARGABS1;ARGABSSG;ARGIO2;ARGIOSG;PAST;POT	eus
V;ARGABS1;ARGABSSG;ARGIO2;ARGIOSG;PRES;IND	eus
V;ARGABS1;ARGABSSG;ARGIO2;ARGIOSG;PRES;POT	eus
V;ARGABS1;ARGABSSG;ARGIO3;ARGIOPL;HYP;IND	eus
V;ARGABS1;ARGABSSG;ARGIO3;ARGIOPL;HYP;POT	eus
V;ARGABS1;ARGABSSG;ARGIO3;ARGIOPL;INFM;FEM;PAST;IND	eus
V;ARGABS1;ARGABSSG;ARGIO3;ARGIOPL;INFM;FEM;PAST;POT	eus
V;ARGABS1;ARGABSSG;ARGIO3;ARGIOPL;INFM;FEM;PRES;IND	eus
V;ARGABS1;ARGABSSG;ARGIO3;ARGIOPL;INFM;MASC;PAST;IND	eus
V;ARGABS1;ARGABSSG;ARGIO3;ARGIOPL;INFM;MASC;PAST;POT	eus
V;ARGABS1;ARGABSSG;ARGIO3;ARGIOPL;INFM;MASC;PRES;IND	eus
V;ARGABS1;ARGABSSG;ARGIO3;ARGIOPL;INFM;MASC;PRES;POT	eus
V;ARGABS1;ARGABSSG;ARGIO3;ARGIOPL;PAST;IND	eus
V;ARGABS1;ARGABSSG;ARGIO3;ARGIOPL;PAST;POT	eus
V;ARGABS1;ARGABSSG;ARGIO3;ARGIOPL;PRES;IND	eus
V;ARGABS1;ARGABSSG;ARGIO3;ARGIOPL;PRES;POT	eus
V;ARGABS1;ARGABSSG;ARGIO3;ARGIOSG;HYP;IND	eus
V;ARGABS1;ARGABSSG;ARGIO3;ARGIOSG;HYP;POT	eus
V;ARGABS1;ARGABSSG;ARGIO3;ARGIOSG;INFM;FEM;PAST;IND	eus
V;ARGABS1;ARGABSSG;ARGIO3;ARGIOSG;INFM;FEM;PAST;POT	eus
V;ARGABS1;ARGABSSG;ARGIO3;ARGIOSG;INFM;FEM;PRES;IND	eus
V;ARGABS1;ARGABSSG;ARGIO3;ARGIOSG;INFM;FEM;PRES;POT	eus
V;ARGABS1;ARGABSSG;ARGIO3;ARGIOSG;INFM;MASC;PAST;IND	eus
V;ARGABS1;ARGABSSG;ARGIO3;ARGIOSG;INFM;MASC;PAST;POT	eus
V;ARGABS1;ARGABSSG;ARGIO3;ARGIOSG;INFM;MASC;PRES;IND	eus
V;ARGABS1;ARGABSSG;ARGIO3;ARGIOSG;INFM;MASC;PRES;POT	eus
V;ARGABS1;ARGABSSG;ARGIO3;ARGIOSG;PAST;IND	eus
V;ARGABS1;ARGABSSG;ARGIO3;ARGIOSG;PAST;POT	eus
V;ARGABS1;ARGABSSG;ARGIO3;ARGIOSG;PRES;IND	eus
V;ARGABS1;ARGABSSG;ARGIO3;ARGIOSG;PRES;POT	eus
V;ARGABS1;ARGABSSG;HYP;IND	eus
V;ARGABS1;ARGABSSG;HYP;POT	eus
V;ARGABS1;ARGABSSG;INFM;FEM;PAST;IND	eus
V;ARGABS1;ARGABSSG;INFM;FEM;PAST;POT	eus
V;ARGABS1;ARGABSSG;INFM;FEM;PRES;IND	eus
V;ARGABS1;ARGABSSG;INFM;FEM;PRES;POT	eus
V;ARGABS1;ARGABSSG;INFM;MASC;PAST;IND	eus
V;ARGABS1;ARGABSSG;INFM;MASC;PAST;POT	eus
V;ARGABS1;ARGABSSG;INFM;MASC;PRES;IND	eus
V;ARGABS1;ARGABSSG;INFM;MASC;PRES;POT	eus
V;ARGABS1;ARGABSSG;PAST;IND	eus
V;ARGABS1;ARGABSSG;PAST;POT	eus
V;ARGABS1;ARGABSSG;PRES;IND	eus
V;ARGABS1;ARGABSSG;PRES;POT	eus
V;ARGABS2;ARGABSSG;ARGABS2;ARGABSPL;ARGERG1;ARGERGPL;HYP;IND	eus
V;ARGABS2;ARGABSSG;ARGABS2;ARGABSPL;ARGERG1;ARGERGPL;HYP;POT	eus
V;ARGABS2;ARGABSSG;ARGABS2;ARGABSPL;ARGERG1;ARGERGPL;PAST;IND	eus
V;ARGABS2;ARGABSSG;ARGABS2;ARGABSPL;ARGERG1;ARGERGPL;PAST;POT	eus
V;ARGABS2;ARGABSSG;ARGABS2;ARGABSPL;ARGERG1;ARGERGPL;PRES;IND	eus
V;ARGABS2;ARGABSSG;ARGABS2;ARGABSPL;ARGERG1;ARGERGPL;PRES;POT	eus
V;ARGABS2;ARGABSSG;ARGABS2;ARGABSPL;ARGERG1;ARGERGSG;HYP;IND	eus
V;ARGABS2;ARGABSSG;ARGABS2;ARGABSPL;ARGERG1;ARGERGSG;HYP;POT	eus
V;ARGABS2;ARGABSSG;ARGABS2;ARGABSPL;ARGERG1;ARGERGSG;PAST;IND	eus
V;ARGABS2;ARGABSSG;ARGABS2;ARGABSPL;ARGERG1;ARGERGSG;PAST;POT	eus
V;ARGABS2;ARGABSSG;ARGABS2;ARGABSPL;ARGERG1;ARGERGSG;PRES;IND	eus
V;ARGABS2;ARGABSSG;ARGABS2;ARGABSPL;ARGERG1;ARGERGSG;PRES;POT	eus
V;ARGABS2;ARGABSSG;ARGABS2;ARGABSPL;ARGERG3;ARGERGPL;HYP;IND	eus
V;ARGABS2;ARGABSSG;ARGABS2;ARGABSPL;ARGERG3;ARGERGPL;HYP;POT	eus
V;ARGABS2;ARGABSSG;ARGABS2;ARGABSPL;ARGERG3;ARGERGPL;PAST;IND	eus
V;ARGABS2;ARGABSSG;ARGABS2;ARGABSPL;ARGERG3;ARGERGPL;PAST;POT	eus
V;ARGABS2;ARGABSSG;ARGABS2;ARGABSPL;ARGERG3;ARGERGPL;PRES;IND	eus
V;ARGABS2;ARGABSSG;ARGABS2;ARGABSPL;ARGERG3;ARGERGPL;PRES;POT	eus
V;ARGABS2;ARGABSSG;ARGABS2;ARGABSPL;ARGERG3;ARGERGSG;HYP;IND	eus
V;ARGABS2;ARGABSSG;ARGABS2;ARGABSPL;ARGERG3;ARGERGSG;HYP;POT	eus
V;ARGABS2;ARGABSSG;ARGABS2;ARGABSPL;ARGERG3;ARGERGSG;PAST;IND	eus
V;ARGABS2;ARGABSSG;ARGABS2;ARGABSPL;ARGERG3;ARGERGSG;PAST;POT	eus
V;ARGABS2;ARGABSSG;ARGABS2;ARGABSPL;ARGERG3;ARGERGSG;PRES;IND	eus
V;ARGABS2;ARGABSSG;ARGABS2;ARGABSPL;ARGERG3;ARGERGSG;PRES;POT	eus
V;ARGABS2;ARGABSSG;ARGABS2;ARGABSPL;ARGIO1;ARGIOPL;HYP;IND	eus
V;ARGABS2;ARGABSSG;ARGABS2;ARGABSPL;ARGIO1;ARGIOPL;HYP;POT	eus
V;ARGABS2;ARGABSSG;ARGABS2;ARGABSPL;ARGIO1;ARGIOPL;IMP	eus
V;ARGABS2;ARGABSSG;ARGABS2;ARGABSPL;ARGIO1;ARGIOPL;PAST;IND	eus
V;ARGABS2;ARGABSSG;ARGABS2;ARGABSPL;ARGIO1;ARGIOPL;PAST;POT	eus
V;ARGABS2;ARGABSSG;ARGABS2;ARGABSPL;ARGIO1;ARGIOPL;PRES;IND	eus
V;ARGABS2;ARGABSSG;ARGABS2;ARGABSPL;ARGIO1;ARGIOPL;PRES;POT	eus
V;ARGABS2;ARGABSSG;ARGABS2;ARGABSPL;ARGIO1;ARGIOSG;HYP;IND	eus
V;ARGABS2;ARGABSSG;ARGABS2;ARGABSPL;ARGIO1;ARGIOSG;HYP;POT	eus
V;ARGABS2;ARGABSSG;ARGABS2;ARGABSPL;ARGIO1;ARGIOSG;IMP	eus
V;ARGABS2;ARGABSSG;ARGABS2;ARGABSPL;ARGIO1;ARGIOSG;PAST;IND	eus
V;ARGABS2;ARGABSSG;ARGABS2;ARGABSPL;ARGIO1;ARGIOSG;PAST;POT	eus
V;ARGABS2;ARGABSSG;ARGABS2;ARGABSPL;ARGIO1;ARGIOSG;PRES;IND	eus
V;ARGABS2;ARGABSSG;ARGABS2;ARGABSPL;ARGIO1;ARGIOSG;PRES;POT	eus
V;ARGABS2;ARGABSSG;ARGABS2;ARGABSPL;ARGIO3;ARGIOPL;HYP;IND	eus
V;ARGABS2;ARGABSSG;ARGABS2;ARGABSPL;ARGIO3;ARGIOPL;HYP;POT	eus
V;ARGABS2;ARGABSSG;ARGABS2;ARGABSPL;ARGIO3;ARGIOPL;IMP	eus
V;ARGABS2;ARGABSSG;ARGABS2;ARGABSPL;ARGIO3;ARGIOPL;PAST;IND	eus
V;ARGABS2;ARGABSSG;ARGABS2;ARGABSPL;ARGIO3;ARGIOPL;PAST;POT	eus
V;ARGABS2;ARGABSSG;ARGABS2;ARGABSPL;ARGIO3;ARGIOPL;PRES;IND	eus
V;ARGABS2;ARGABSSG;ARGABS2;ARGABSPL;ARGIO3;ARGIOPL;PRES;POT	eus
V;ARGABS2;ARGABSSG;ARGABS2;ARGABSPL;ARGIO3;ARGIOSG;HYP;IND	eus
V;ARGABS2;ARGABSSG;ARGABS2;ARGABSPL;ARGIO3;ARGIOSG;HYP;POT	eus
V;ARGABS2;ARGABSSG;ARGABS2;ARGABSPL;ARGIO3;ARGIOSG;IMP	eus
V;ARGABS2;ARGABSSG;ARGABS2;ARGABSPL;ARGIO3;ARGIOSG;PAST;IND	eus
V;ARGABS2;ARGABSSG;ARGABS2;ARGABSPL;ARGIO3;ARGIOSG;PAST;POT	eus
V;ARGABS2;ARGABSSG;ARGABS2;ARGABSPL;ARGIO3;ARGIOSG;PRES;IND	eus
V;ARGABS2;ARGABSSG;ARGABS2;ARGABSPL;ARGIO3;ARGIOSG;PRES;POT	eus
V;ARGABS2;ARGABSSG;ARGABS2;ARGABSPL;HYP;IND	eus
V;ARGABS2;ARGABSSG;ARGABS2;ARGABSPL;HYP;POT	eus
V;ARGABS2;ARGABSSG;ARGABS2;ARGABSPL;IMP	eus
V;ARGABS2;ARGABSSG;ARGABS2;ARGABSPL;PAST;IND	eus
V;ARGABS2;ARGABSSG;ARGABS2;ARGABSPL;PAST;POT	eus
V;ARGABS2;ARGABSSG;ARGABS2;ARGABSPL;PRES;IND	eus
V;ARGABS2;ARGABSSG;ARGABS2;ARGABSPL;PRES;POT	eus
V;ARGABS2;ARGABSSG;ARGABSINFM;ARGERG1;ARGERGSG;HYP;IND	eus
V;ARGABS2;ARGABSSG;ARGABSINFM;ARGERG1;ARGERGSG;HYP;POT	eus
V;ARGABS2;ARGABSSG;ARGABSINFM;ARGERG1;ARGERGSG;PAST;POT	eus
V;ARGABS2;ARGABSSG;ARGABSINFM;ARGERG1;ARGERGSG;PRES;IND	eus
V;ARGABS2;ARGABSSG;ARGABSINFM;ARGERG3;ARGERGPL;HYP;IND	eus
V;ARGABS2;ARGABSSG;ARGABSINFM;ARGERG3;ARGERGPL;HYP;POT	eus
V;ARGABS2;ARGABSSG;ARGABSINFM;ARGERG3;ARGERGPL;PAST;IND	eus
V;ARGABS2;ARGABSSG;ARGABSINFM;ARGERG3;ARGERGPL;PAST;POT	eus
V;ARGABS2;ARGABSSG;ARGABSINFM;ARGERG3;ARGERGPL;PRES;IND	eus
V;ARGABS2;ARGABSSG;ARGABSINFM;ARGIO1;ARGIOPL;HYP;IND	eus
V;ARGABS2;ARGABSSG;ARGABSINFM;ARGIO1;ARGIOPL;HYP;POT	eus
V;ARGABS2;ARGABSSG;ARGABSINFM;ARGIO1;ARGIOPL;IMP	eus
V;ARGABS2;ARGABSSG;ARGABSINFM;ARGIO1;ARGIOPL;PAST;IND	eus
V;ARGABS2;ARGABSSG;ARGABSINFM;ARGIO1;ARGIOPL;PAST;POT	eus
V;ARGABS2;ARGABSSG;ARGABSINFM;ARGIO1;ARGIOPL;PRES;IND	eus
V;ARGABS2;ARGABSSG;ARGABSINFM;ARGIO1;ARGIOPL;PRES;POT	eus
V;ARGABS2;ARGABSSG;ARGABSINFM;ARGIO1;ARGIOSG;HYP;IND	eus
V;ARGABS2;ARGABSSG;ARGABSINFM;ARGIO1;ARGIOSG;HYP;POT	eus
V;ARGABS2;ARGABSSG;ARGABSINFM;ARGIO1;ARGIOSG;IMP	eus
V;ARGABS2;ARGABSSG;ARGABSINFM;ARGIO1;ARGIOSG;PAST;IND	eus
V;ARGABS2;ARGABSSG;ARGABSINFM;ARGIO1;ARGIOSG;PAST;POT	eus
V;ARGABS2;ARGABSSG;ARGABSINFM;ARGIO1;ARGIOSG;PRES;IND	eus
V;ARGABS2;ARGABSSG;ARGABSINFM;ARGIO1;ARGIOSG;PRES;POT	eus
V;ARGABS2;ARGABSSG;ARGABSINFM;ARGIO3;ARGIOPL;HYP;IND	eus
V;ARGABS2;ARGABSSG;ARGABSINFM;ARGIO3;ARGIOPL;HYP;POT	eus
V;ARGABS2;ARGABSSG;ARGABSINFM;ARGIO3;ARGIOPL;IMP	eus
V;ARGABS2;ARGABSSG;ARGABSINFM;ARGIO3;ARGIOPL;PAST;IND	eus
V;ARGABS2;ARGABSSG;ARGABSINFM;ARGIO3;ARGIOPL;PAST;POT	eus
V;ARGABS2;ARGABSSG;ARGABSINFM;ARGIO3;ARGIOPL;PRES;IND	eus
V;ARGABS2;ARGABSSG;ARGABSINFM;ARGIO3;ARGIOPL;PRES;POT	eus
V;ARGABS2;ARGABSSG;ARGABSINFM;ARGIO3;ARGIOSG;HYP;IND	eus
V;ARGABS2;ARGABSSG;ARGABSINFM;ARGIO3;ARGIOSG;HYP;POT	eus
V;ARGABS2;ARGABSSG;ARGABSINFM;ARGIO3;ARGIOSG;IMP	eus
V;ARGABS2;ARGABSSG;ARGABSINFM;ARGIO3;ARGIOSG;PAST;IND	eus
V;ARGABS2;ARGABSSG;ARGABSINFM;ARGIO3;ARGIOSG;PAST;POT	eus
V;ARGABS2;ARGABSSG;ARGABSINFM;ARGIO3;ARGIOSG;PRES;IND	eus
V;ARGABS2;ARGABSSG;ARGABSINFM;ARGIO3;ARGIOSG;PRES;POT	eus
V;ARGABS2;ARGABSSG;ARGABSINFM;HYP;IND	eus
V;ARGABS2;ARGABSSG;ARGABSINFM;HYP;POT	eus
V;ARGABS2;ARGABSSG;ARGABSINFM;IMP	eus
V;ARGABS2;ARGABSSG;ARGABSINFM;PAST;IND	eus
V;ARGABS2;ARGABSSG;ARGABSINFM;PAST;POT	eus
V;ARGABS2;ARGABSSG;ARGABSINFM;PRES;IND	eus
V;ARGABS2;ARGABSSG;ARGABSINFM;PRES;POT	eus
V;ARGABS2;ARGABSSG;ARGERG1;ARGERGPL;PAST;POT	eus
V;ARGABS2;ARGABSSG;ARGERG1;ARGERGSG;HYP;IND	eus
V;ARGABS2;ARGABSSG;ARGERG1;ARGERGSG;HYP;POT	eus
V;ARGABS2;ARGABSSG;ARGERG1;ARGERGSG;PAST;POT	eus
V;ARGABS2;ARGABSSG;ARGERG1;ARGERGSG;PRES;IND	eus
V;ARGABS2;ARGABSSG;ARGERG1;ARGERGSG;PRES;POT	eus
V;ARGABS2;ARGABSSG;ARGERG3;ARGERGPL;HYP;IND	eus
V;ARGABS2;ARGABSSG;ARGERG3;ARGERGPL;HYP;POT	eus
V;ARGABS2;ARGABSSG;ARGERG3;ARGERGPL;PAST;IND	eus
V;ARGABS2;ARGABSSG;ARGERG3;ARGERGPL;PAST;POT	eus
V;ARGABS2;ARGABSSG;ARGERG3;ARGERGPL;PRES;IND	eus
V;ARGABS2;ARGABSSG;ARGERG3;ARGERGPL;PRES;POT	eus
V;ARGABS2;ARGABSSG;ARGERG3;ARGERGSG;PAST;POT	eus
V;ARGABS2;ARGABSSG;ARGIO1;ARGIOPL;HYP;IND	eus
V;ARGABS2;ARGABSSG;ARGIO1;ARGIOPL;HYP;POT	eus
V;ARGABS2;ARGABSSG;ARGIO1;ARGIOPL;IMP	eus
V;ARGABS2;ARGABSSG;ARGIO1;ARGIOPL;PAST;IND	eus
V;ARGABS2;ARGABSSG;ARGIO1;ARGIOPL;PAST;POT	eus
V;ARGABS2;ARGABSSG;ARGIO1;ARGIOPL;PRES;IND	eus
V;ARGABS2;ARGABSSG;ARGIO1;ARGIOPL;PRES;POT	eus
V;ARGABS2;ARGABSSG;ARGIO1;ARGIOSG;HYP;IND	eus
V;ARGABS2;ARGABSSG;ARGIO1;ARGIOSG;HYP;POT	eus
V;ARGABS2;ARGABSSG;ARGIO1;ARGIOSG;IMP	eus
V;ARGABS2;ARGABSSG;ARGIO1;ARGIOSG;PAST;IND	eus
V;ARGABS2;ARGABSSG;ARGIO1;ARGIOSG;PAST;POT	eus
V;ARGABS2;ARGABSSG;ARGIO1;ARGIOSG;PRES;IND	eus
V;ARGABS2;ARGABSSG;ARGIO1;ARGIOSG;PRES;POT	eus
V;ARGABS2;ARGABSSG;ARGIO3;ARGIOPL;HYP;IND	eus
V;ARGABS2;ARGABSSG;ARGIO3;ARGIOPL;HYP;POT	eus
V;ARGABS2;ARGABSSG;ARGIO3;ARGIOPL;IMP	eus
V;ARGABS2;ARGABSSG;ARGIO3;ARGIOPL;PAST;IND	eus
V;ARGABS2;ARGABSSG;ARGIO3;ARGIOPL;PAST;POT	eus
V;ARGABS2;ARGABSSG;ARGIO3;ARGIOPL;PRES;IND	eus
V;ARGABS2;ARGABSSG;ARGIO3;ARGIOPL;PRES;POT	eus
V;ARGABS2;ARGABSSG;ARGIO3;ARGIOSG;HYP;IND	eus
V;ARGABS2;ARGABSSG;ARGIO3;ARGIOSG;HYP;POT	eus
V;ARGABS2;ARGABSSG;ARGIO3;ARGIOSG;IMP	eus
V;ARGABS2;ARGABSSG;ARGIO3;ARGIOSG;PAST;IND	eus
V;ARGABS2;ARGABSSG;ARGIO3;ARGIOSG;PAST;POT	eus
V;ARGABS2;ARGABSSG;ARGIO3;ARGIOSG;PRES;IND	eus
V;ARGABS2;ARGABSSG;ARGIO3;ARGIOSG;PRES;POT	eus
V;ARGABS2;ARGABSSG;HYP;IND	eus
V;ARGABS2;ARGABSSG;HYP;POT	eus
V;ARGABS2;ARGABSSG;IMP	eus
V;ARGABS2;ARGABSSG;PAST;IND	eus
V;ARGABS2;ARGABSSG;PAST;POT	eus
V;ARGABS2;ARGABSSG;PRES;IND	eus
V;ARGABS2;ARGABSSG;PRES;POT	eus
V;ARGABS3;ARGABSPL;ARGERG1;ARGERGPL;HYP;IND	eus
V;ARGABS3;ARGABSPL;ARGERG1;ARGERGPL;HYP;POT	eus
V;ARGABS3;ARGABSPL;ARGERG1;ARGERGPL;INFM;FEM;PAST;IND	eus
V;ARGABS3;ARGABSPL;ARGERG1;ARGERGPL;INFM;FEM;PRES;IND	eus
V;ARGABS3;ARGABSPL;ARGERG1;ARGERGPL;INFM;MASC;PAST;IND	eus
V;ARGABS3;ARGABSPL;ARGERG1;ARGERGPL;INFM;MASC;PRES;IND	eus
V;ARGABS3;ARGABSPL;ARGERG1;ARGERGPL;PAST;IND	eus
V;ARGABS3;ARGABSPL;ARGERG1;ARGERGPL;PAST;POT	eus
V;ARGABS3;ARGABSPL;ARGERG1;ARGERGPL;PRES;IND	eus
V;ARGABS3;ARGABSPL;ARGERG1;ARGERGSG;HYP;IND	eus
V;ARGABS3;ARGABSPL;ARGERG1;ARGERGSG;HYP;POT	eus
V;ARGABS3;ARGABSPL;ARGERG1;ARGERGSG;INFM;FEM;PAST;IND	eus
V;ARGABS3;ARGABSPL;ARGERG1;ARGERGSG;INFM;FEM;PRES;IND	eus
V;ARGABS3;ARGABSPL;ARGERG1;ARGERGSG;INFM;FEM;PRES;POT	eus
V;ARGABS3;ARGABSPL;ARGERG1;ARGERGSG;INFM;MASC;PAST;IND	eus
V;ARGABS3;ARGABSPL;ARGERG1;ARGERGSG;INFM;MASC;PRES;IND	eus
V;ARGABS3;ARGABSPL;ARGERG1;ARGERGSG;INFM;MASC;PRES;POT	eus
V;ARGABS3;ARGABSPL;ARGERG1;ARGERGSG;PAST;IND	eus
V;ARGABS3;ARGABSPL;ARGERG1;ARGERGSG;PAST;POT	eus
V;ARGABS3;ARGABSPL;ARGERG1;ARGERGSG;PRES;IND	eus
V;ARGABS3;ARGABSPL;ARGERG1;ARGERGSG;PRES;POT	eus
V;ARGABS3;ARGABSPL;ARGERG2;ARGERGPL;ARGIO1;ARGIOPL;IMP	eus
V;ARGABS3;ARGABSPL;ARGERG2;ARGERGPL;ARGIO1;ARGIOSG;HYP;IND	eus
V;ARGABS3;ARGABSPL;ARGERG2;ARGERGPL;ARGIO1;ARGIOSG;HYP;POT	eus
V;ARGABS3;ARGABSPL;ARGERG2;ARGERGPL;ARGIO1;ARGIOSG;IMP	eus
V;ARGABS3;ARGABSPL;ARGERG2;ARGERGPL;ARGIO1;ARGIOSG;PAST;IND	eus
V;ARGABS3;ARGABSPL;ARGERG2;ARGERGPL;ARGIO1;ARGIOSG;PAST;POT	eus
V;ARGABS3;ARGABSPL;ARGERG2;ARGERGPL;ARGIO3;ARGIOPL;HYP;IND	eus
V;ARGABS3;ARGABSPL;ARGERG2;ARGERGPL;ARGIO3;ARGIOPL;HYP;POT	eus
V;ARGABS3;ARGABSPL;ARGERG2;ARGERGPL;ARGIO3;ARGIOPL;IMP	eus
V;ARGABS3;ARGABSPL;ARGERG2;ARGERGPL;ARGIO3;ARGIOPL;PAST;IND	eus
V;ARGABS3;ARGABSPL;ARGERG2;ARGERGPL;ARGIO3;ARGIOPL;PAST;POT	eus
V;ARGABS3;ARGABSPL;ARGERG2;ARGERGPL;ARGIO3;ARGIOSG;HYP;IND	eus
V;ARGABS3;ARGABSPL;ARGERG2;ARGERGPL;ARGIO3;ARGIOSG;HYP;POT	eus
V;ARGABS3;ARGABSPL;ARGERG2;ARGERGPL;ARGIO3;ARGIOSG;IMP	eus
V;ARGABS3;ARGABSPL;ARGERG2;ARGERGPL;ARGIO3;ARGIOSG;PAST;IND	eus
V;ARGABS3;ARGABSPL;ARGERG2;ARGERGPL;ARGIO3;ARGIOSG;PAST;POT	eus
V;ARGABS3;ARGABSPL;ARGERG2;ARGERGPL;HYP;IND	eus
V;ARGABS3;ARGABSPL;ARGERG2;ARGERGPL;HYP;POT	eus
V;ARGABS3;ARGABSPL;ARGERG2;ARGERGPL;PAST;IND	eus
V;ARGABS3;ARGABSPL;ARGERG2;ARGERGPL;PAST;POT	eus
V;ARGABS3;ARGABSPL;ARGERG2;ARGERGPL;PRES;IND	eus
V;ARGABS3;ARGABSPL;ARGERG2;ARGERGSG;ARGERGINFM;ARGERGFEM;ARGIO1;ARGIOPL;IMP	eus
V;ARGABS3;ARGABSPL;ARGERG2;ARGERGSG;ARGERGINFM;ARGERGFEM;ARGIO1;ARGIOSG;IMP	eus
V;ARGABS3;ARGABSPL;ARGERG2;ARGERGSG;ARGERGINFM;ARGERGFEM;ARGIO3;ARGIOPL;IMP	eus
V;ARGABS3;ARGABSPL;ARGERG2;ARGERGSG;ARGERGINFM;ARGERGFEM;ARGIO3;ARGIOSG;IMP	eus
V;ARGABS3;ARGABSPL;ARGERG2;ARGERGSG;ARGERGINFM;ARGERGFEM;PRES;IND	eus
V;ARGABS3;ARGABSPL;ARGERG2;ARGERGSG;ARGERGINFM;ARGERGMASC;ARGIO1;ARGIOPL;IMP	eus
V;ARGABS3;ARGABSPL;ARGERG2;ARGERGSG;ARGERGINFM;ARGERGMASC;ARGIO1;ARGIOSG;IMP	eus
V;ARGABS3;ARGABSPL;ARGERG2;ARGERGSG;ARGERGINFM;ARGERGMASC;ARGIO3;ARGIOPL;IMP	eus
V;ARGABS3;ARGABSPL;ARGERG2;ARGERGSG;ARGERGINFM;ARGERGMASC;ARGIO3;ARGIOSG;IMP	eus
V;ARGABS3;ARGABSPL;ARGERG2;ARGERGSG;ARGERGINFM;ARGERGMASC;PRES;IND	eus
V;ARGABS3;ARGABSPL;ARGERG2;ARGERGSG;ARGERGINFM;HYP;IND	eus
V;ARGABS3;ARGABSPL;ARGERG2;ARGERGSG;ARGERGINFM;HYP;POT	eus
V;ARGABS3;ARGABSPL;ARGERG2;ARGERGSG;ARGERGINFM;PAST;IND	eus
V;ARGABS3;ARGABSPL;ARGERG2;ARGERGSG;ARGERGINFM;PAST;POT	eus
V;ARGABS3;ARGABSPL;ARGERG2;ARGERGSG;ARGIO1;ARGIOPL;IMP	eus
V;ARGABS3;ARGABSPL;ARGERG2;ARGERGSG;ARGIO1;ARGIOSG;IMP	eus
V;ARGABS3;ARGABSPL;ARGERG2;ARGERGSG;ARGIO3;ARGIOPL;IMP	eus
V;ARGABS3;ARGABSPL;ARGERG2;ARGERGSG;ARGIO3;ARGIOSG;IMP	eus
V;ARGABS3;ARGABSPL;ARGERG2;ARGERGSG;HYP;IND	eus
V;ARGABS3;ARGABSPL;ARGERG2;ARGERGSG;HYP;POT	eus
V;ARGABS3;ARGABSPL;ARGERG2;ARGERGSG;PAST;IND	eus
V;ARGABS3;ARGABSPL;ARGERG2;ARGERGSG;PAST;POT	eus
V;ARGABS3;ARGABSPL;ARGERG2;ARGERGSG;PRES;IND	eus
V;ARGABS3;ARGABSPL;ARGERG3;ARGERGPL;ARGIO1;ARGIOPL;IMP	eus
V;ARGABS3;ARGABSPL;ARGERG3;ARGERGPL;ARGIO1;ARGIOSG;HYP;IND	eus
V;ARGABS3;ARGABSPL;ARGERG3;ARGERGPL;ARGIO1;ARGIOSG;HYP;POT	eus
V;ARGABS3;ARGABSPL;ARGERG3;ARGERGPL;ARGIO1;ARGIOSG;IMP	eus
V;ARGABS3;ARGABSPL;ARGERG3;ARGERGPL;ARGIO1;ARGIOSG;INFM;FEM;PAST;IND	eus
V;ARGABS3;ARGABSPL;ARGERG3;ARGERGPL;ARGIO1;ARGIOSG;INFM;FEM;PRES;IND	eus
V;ARGABS3;ARGABSPL;ARGERG3;ARGERGPL;ARGIO1;ARGIOSG;INFM;MASC;PAST;IND	eus
V;ARGABS3;ARGABSPL;ARGERG3;ARGERGPL;ARGIO1;ARGIOSG;INFM;MASC;PRES;IND	eus
V;ARGABS3;ARGABSPL;ARGERG3;ARGERGPL;ARGIO1;ARGIOSG;PAST;IND	eus
V;ARGABS3;ARGABSPL;ARGERG3;ARGERGPL;ARGIO1;ARGIOSG;PAST;POT	eus
V;ARGABS3;ARGABSPL;ARGERG3;ARGERGPL;ARGIO1;ARGIOSG;PRES;IND	eus
V;ARGABS3;ARGABSPL;ARGERG3;ARGERGPL;ARGIO2;ARGIOPL;HYP;IND	eus
V;ARGABS3;ARGABSPL;ARGERG3;ARGERGPL;ARGIO2;ARGIOPL;HYP;POT	eus
V;ARGABS3;ARGABSPL;ARGERG3;ARGERGPL;ARGIO2;ARGIOPL;IMP	eus
V;ARGABS3;ARGABSPL;ARGERG3;ARGERGPL;ARGIO2;ARGIOPL;PAST;IND	eus
V;ARGABS3;ARGABSPL;ARGERG3;ARGERGPL;ARGIO2;ARGIOPL;PAST;POT	eus
V;ARGABS3;ARGABSPL;ARGERG3;ARGERGPL;ARGIO2;ARGIOPL;PRES;IND	eus
V;ARGABS3;ARGABSPL;ARGERG3;ARGERGPL;ARGIO2;ARGIOSG;ARGIOINFM;ARGIOFEM;IMP	eus
V;ARGABS3;ARGABSPL;ARGERG3;ARGERGPL;ARGIO2;ARGIOSG;ARGIOINFM;ARGIOMASC;HYP;IND	eus
V;ARGABS3;ARGABSPL;ARGERG3;ARGERGPL;ARGIO2;ARGIOSG;ARGIOINFM;ARGIOMASC;HYP;POT	eus
V;ARGABS3;ARGABSPL;ARGERG3;ARGERGPL;ARGIO2;ARGIOSG;ARGIOINFM;ARGIOMASC;IMP	eus
V;ARGABS3;ARGABSPL;ARGERG3;ARGERGPL;ARGIO2;ARGIOSG;ARGIOINFM;ARGIOMASC;PAST;POT	eus
V;ARGABS3;ARGABSPL;ARGERG3;ARGERGPL;ARGIO2;ARGIOSG;HYP;IND	eus
V;ARGABS3;ARGABSPL;ARGERG3;ARGERGPL;ARGIO2;ARGIOSG;HYP;POT	eus
V;ARGABS3;ARGABSPL;ARGERG3;ARGERGPL;ARGIO2;ARGIOSG;IMP	eus
V;ARGABS3;ARGABSPL;ARGERG3;ARGERGPL;ARGIO2;ARGIOSG;PAST;IND	eus
V;ARGABS3;ARGABSPL;ARGERG3;ARGERGPL;ARGIO2;ARGIOSG;PAST;POT	eus
V;ARGABS3;ARGABSPL;ARGERG3;ARGERGPL;ARGIO2;ARGIOSG;PRES;IND	eus
V;ARGABS3;ARGABSPL;ARGERG3;ARGERGPL;ARGIO3;ARGIOPL;HYP;IND	eus
V;ARGABS3;ARGABSPL;ARGERG3;ARGERGPL;ARGIO3;ARGIOPL;HYP;POT	eus
V;ARGABS3;ARGABSPL;ARGERG3;ARGERGPL;ARGIO3;ARGIOPL;IMP	eus
V;ARGABS3;ARGABSPL;ARGERG3;ARGERGPL;ARGIO3;ARGIOPL;INFM;FEM;PAST;IND	eus
V;ARGABS3;ARGABSPL;ARGERG3;ARGERGPL;ARGIO3;ARGIOPL;INFM;FEM;PRES;IND	eus
V;ARGABS3;ARGABSPL;ARGERG3;ARGERGPL;ARGIO3;ARGIOPL;INFM;MASC;PAST;IND	eus
V;ARGABS3;ARGABSPL;ARGERG3;ARGERGPL;ARGIO3;ARGIOPL;INFM;MASC;PRES;IND	eus
V;ARGABS3;ARGABSPL;ARGERG3;ARGERGPL;ARGIO3;ARGIOPL;PAST;IND	eus
V;ARGABS3;ARGABSPL;ARGERG3;ARGERGPL;ARGIO3;ARGIOPL;PAST;POT	eus
V;ARGABS3;ARGABSPL;ARGERG3;ARGERGPL;ARGIO3;ARGIOPL;PRES;IND	eus
V;ARGABS3;ARGABSPL;ARGERG3;ARGERGPL;ARGIO3;ARGIOSG;HYP;IND	eus
V;ARGABS3;ARGABSPL;ARGERG3;ARGERGPL;ARGIO3;ARGIOSG;HYP;POT	eus
V;ARGABS3;ARGABSPL;ARGERG3;ARGERGPL;ARGIO3;ARGIOSG;IMP	eus
V;ARGABS3;ARGABSPL;ARGERG3;ARGERGPL;ARGIO3;ARGIOSG;INFM;FEM;PRES;IND	eus
V;ARGABS3;ARGABSPL;ARGERG3;ARGERGPL;ARGIO3;ARGIOSG;INFM;MASC;PAST;IND	eus
V;ARGABS3;ARGABSPL;ARGERG3;ARGERGPL;ARGIO3;ARGIOSG;INFM;MASC;PRES;IND	eus
V;ARGABS3;ARGABSPL;ARGERG3;ARGERGPL;ARGIO3;ARGIOSG;PAST;IND	eus
V;ARGABS3;ARGABSPL;ARGERG3;ARGERGPL;ARGIO3;ARGIOSG;PAST;POT	eus
V;ARGABS3;ARGABSPL;ARGERG3;ARGERGPL;ARGIO3;ARGIOSG;PRES;IND	eus
V;ARGABS3;ARGABSPL;ARGERG3;ARGERGPL;HYP;IND	eus
V;ARGABS3;ARGABSPL;ARGERG3;ARGERGPL;HYP;POT	eus
V;ARGABS3;ARGABSPL;ARGERG3;ARGERGPL;IMP	eus
V;ARGABS3;ARGABSPL;ARGERG3;ARGERGPL;INFM;FEM;HYP;POT	eus
V;ARGABS3;ARGABSPL;ARGERG3;ARGERGPL;INFM;FEM;PAST;IND	eus
V;ARGABS3;ARGABSPL;ARGERG3;ARGERGPL;INFM;FEM;PAST;POT	eus
V;ARGABS3;ARGABSPL;ARGERG3;ARGERGPL;INFM;FEM;PRES;IND	eus
V;ARGABS3;ARGABSPL;ARGERG3;ARGERGPL;INFM;FEM;PRES;POT	eus
V;ARGABS3;ARGABSPL;ARGERG3;ARGERGPL;INFM;MASC;HYP;POT	eus
V;ARGABS3;ARGABSPL;ARGERG3;ARGERGPL;INFM;MASC;PAST;IND	eus
V;ARGABS3;ARGABSPL;ARGERG3;ARGERGPL;INFM;MASC;PAST;POT	eus
V;ARGABS3;ARGABSPL;ARGERG3;ARGERGPL;INFM;MASC;PRES;IND	eus
V;ARGABS3;ARGABSPL;ARGERG3;ARGERGPL;INFM;MASC;PRES;POT	eus
V;ARGABS3;ARGABSPL;ARGERG3;ARGERGPL;PAST;IND	eus
V;ARGABS3;ARGABSPL;ARGERG3;ARGERGPL;PAST;POT	eus
V;ARGABS3;ARGABSPL;ARGERG3;ARGERGPL;PRES;IND	eus
V;ARGABS3;ARGABSPL;ARGERG3;ARGERGPL;PRES;POT	eus
V;ARGABS3;ARGABSPL;ARGERG3;ARGERGSG;ARGIO1;ARGIOSG;IMP	eus
V;ARGABS3;ARGABSPL;ARGERG3;ARGERGSG;ARGIO2;ARGIOPL;IMP	eus
V;ARGABS3;ARGABSPL;ARGERG3;ARGERGSG;ARGIO2;ARGIOSG;ARGIOINFM;ARGIOFEM;IMP	eus
V;ARGABS3;ARGABSPL;ARGERG3;ARGERGSG;ARGIO2;ARGIOSG;ARGIOINFM;ARGIOMASC;IMP	eus
V;ARGABS3;ARGABSPL;ARGERG3;ARGERGSG;ARGIO2;ARGIOSG;IMP	eus
V;ARGABS3;ARGABSPL;ARGERG3;ARGERGSG;ARGIO3;ARGIOPL;IMP	eus
V;ARGABS3;ARGABSPL;ARGERG3;ARGERGSG;ARGIO3;ARGIOSG;IMP	eus
V;ARGABS3;ARGABSPL;ARGERG3;ARGERGSG;HYP;IND	eus
V;ARGABS3;ARGABSPL;ARGERG3;ARGERGSG;HYP;POT	eus
V;ARGABS3;ARGABSPL;ARGERG3;ARGERGSG;IMP	eus
V;ARGABS3;ARGABSPL;ARGERG3;ARGERGSG;INFM;FEM;PAST;IND	eus
V;ARGABS3;ARGABSPL;ARGERG3;ARGERGSG;INFM;FEM;PRES;IND	eus
V;ARGABS3;ARGABSPL;ARGERG3;ARGERGSG;INFM;MASC;PAST;IND	eus
V;ARGABS3;ARGABSPL;ARGERG3;ARGERGSG;INFM;MASC;PRES;IND	eus
V;ARGABS3;ARGABSPL;ARGERG3;ARGERGSG;PAST;IND	eus
V;ARGABS3;ARGABSPL;ARGERG3;ARGERGSG;PAST;POT	eus
V;ARGABS3;ARGABSPL;ARGERG3;ARGERGSG;PRES;IND	eus
V;ARGABS3;ARGABSPL;ARGIO1;ARGIOPL;HYP;IND	eus
V;ARGABS3;ARGABSPL;ARGIO1;ARGIOPL;HYP;POT	eus
V;ARGABS3;ARGABSPL;ARGIO1;ARGIOPL;IMP	eus
V;ARGABS3;ARGABSPL;ARGIO1;ARGIOPL;INFM;FEM;PAST;IND	eus
V;ARGABS3;ARGABSPL;ARGIO1;ARGIOPL;INFM;FEM;PAST;POT	eus
V;ARGABS3;ARGABSPL;ARGIO1;ARGIOPL;INFM;FEM;PRES;IND	eus
V;ARGABS3;ARGABSPL;ARGIO1;ARGIOPL;INFM;MASC;PAST;IND	eus
V;ARGABS3;ARGABSPL;ARGIO1;ARGIOPL;INFM;MASC;PAST;POT	eus
V;ARGABS3;ARGABSPL;ARGIO1;ARGIOPL;INFM;MASC;PRES;IND	eus
V;ARGABS3;ARGABSPL;ARGIO1;ARGIOPL;INFM;MASC;PRES;POT	eus
V;ARGABS3;ARGABSPL;ARGIO1;ARGIOPL;PAST;IND	eus
V;ARGABS3;ARGABSPL;ARGIO1;ARGIOPL;PAST;POT	eus
V;ARGABS3;ARGABSPL;ARGIO1;ARGIOPL;PRES;IND	eus
V;ARGABS3;ARGABSPL;ARGIO1;ARGIOPL;PRES;POT	eus
V;ARGABS3;ARGABSPL;ARGIO1;ARGIOSG;HYP;IND	eus
V;ARGABS3;ARGABSPL;ARGIO1;ARGIOSG;HYP;POT	eus
V;ARGABS3;ARGABSPL;ARGIO1;ARGIOSG;IMP	eus
V;ARGABS3;ARGABSPL;ARGIO1;ARGIOSG;INFM;FEM;PAST;IND	eus
V;ARGABS3;ARGABSPL;ARGIO1;ARGIOSG;INFM;FEM;PAST;POT	eus
V;ARGABS3;ARGABSPL;ARGIO1;ARGIOSG;INFM;FEM;PRES;IND	eus
V;ARGABS3;ARGABSPL;ARGIO1;ARGIOSG;INFM;FEM;PRES;POT	eus
V;ARGABS3;ARGABSPL;ARGIO1;ARGIOSG;INFM;MASC;PAST;IND	eus
V;ARGABS3;ARGABSPL;ARGIO1;ARGIOSG;INFM;MASC;PAST;POT	eus
V;ARGABS3;ARGABSPL;ARGIO1;ARGIOSG;INFM;MASC;PRES;IND	eus
V;ARGABS3;ARGABSPL;ARGIO1;ARGIOSG;INFM;MASC;PRES;POT	eus
V;ARGABS3;ARGABSPL;ARGIO1;ARGIOSG;PAST;IND	eus
V;ARGABS3;ARGABSPL;ARGIO1;ARGIOSG;PAST;POT	eus
V;ARGABS3;ARGABSPL;ARGIO1;ARGIOSG;PRES;IND	eus
V;ARGABS3;ARGABSPL;ARGIO1;ARGIOSG;PRES;POT	eus
V;ARGABS3;ARGABSPL;ARGIO2;ARGIOPL;HYP;IND	eus
V;ARGABS3;ARGABSPL;ARGIO2;ARGIOPL;HYP;POT	eus
V;ARGABS3;ARGABSPL;ARGIO2;ARGIOPL;IMP	eus
V;ARGABS3;ARGABSPL;ARGIO2;ARGIOPL;PAST;IND	eus
V;ARGABS3;ARGABSPL;ARGIO2;ARGIOPL;PAST;POT	eus
V;ARGABS3;ARGABSPL;ARGIO2;ARGIOPL;PRES;IND	eus
V;ARGABS3;ARGABSPL;ARGIO2;ARGIOPL;PRES;POT	eus
V;ARGABS3;ARGABSPL;ARGIO2;ARGIOSG;ARGIOINFM;ARGIOFEM;HYP;IND	eus
V;ARGABS3;ARGABSPL;ARGIO2;ARGIOSG;ARGIOINFM;ARGIOFEM;HYP;POT	eus
V;ARGABS3;ARGABSPL;ARGIO2;ARGIOSG;ARGIOINFM;ARGIOFEM;IMP	eus
V;ARGABS3;ARGABSPL;ARGIO2;ARGIOSG;ARGIOINFM;ARGIOFEM;PAST;IND	eus
V;ARGABS3;ARGABSPL;ARGIO2;ARGIOSG;ARGIOINFM;ARGIOFEM;PAST;POT	eus
V;ARGABS3;ARGABSPL;ARGIO2;ARGIOSG;ARGIOINFM;ARGIOFEM;PRES;IND	eus
V;ARGABS3;ARGABSPL;ARGIO2;ARGIOSG;ARGIOINFM;ARGIOFEM;PRES;POT	eus
V;ARGABS3;ARGABSPL;ARGIO2;ARGIOSG;ARGIOINFM;ARGIOMASC;HYP;IND	eus
V;ARGABS3;ARGABSPL;ARGIO2;ARGIOSG;ARGIOINFM;ARGIOMASC;HYP;POT	eus
V;ARGABS3;ARGABSPL;ARGIO2;ARGIOSG;ARGIOINFM;ARGIOMASC;IMP	eus
V;ARGABS3;ARGABSPL;ARGIO2;ARGIOSG;ARGIOINFM;ARGIOMASC;PAST;IND	eus
V;ARGABS3;ARGABSPL;ARGIO2;ARGIOSG;ARGIOINFM;ARGIOMASC;PAST;POT	eus
V;ARGABS3;ARGABSPL;ARGIO2;ARGIOSG;ARGIOINFM;ARGIOMASC;PRES;IND	eus
V;ARGABS3;ARGABSPL;ARGIO2;ARGIOSG;ARGIOINFM;ARGIOMASC;PRES;POT	eus
V;ARGABS3;ARGABSPL;ARGIO2;ARGIOSG;HYP;IND	eus
V;ARGABS3;ARGABSPL;ARGIO2;ARGIOSG;HYP;POT	eus
V;ARGABS3;ARGABSPL;ARGIO2;ARGIOSG;IMP	eus
V;ARGABS3;ARGABSPL;ARGIO2;ARGIOSG;PAST;IND	eus
V;ARGABS3;ARGABSPL;ARGIO2;ARGIOSG;PAST;POT	eus
V;ARGABS3;ARGABSPL;ARGIO2;ARGIOSG;PRES;IND	eus
V;ARGABS3;ARGABSPL;ARGIO2;ARGIOSG;PRES;POT	eus
V;ARGABS3;ARGABSPL;ARGIO3;ARGIOPL;HYP;IND	eus
V;ARGABS3;ARGABSPL;ARGIO3;ARGIOPL;HYP;POT	eus
V;ARGABS3;ARGABSPL;ARGIO3;ARGIOPL;IMP	eus
V;ARGABS3;ARGABSPL;ARGIO3;ARGIOPL;INFM;FEM;PAST;IND	eus
V;ARGABS3;ARGABSPL;ARGIO3;ARGIOPL;INFM;FEM;PAST;POT	eus
V;ARGABS3;ARGABSPL;ARGIO3;ARGIOPL;INFM;FEM;PRES;IND	eus
V;ARGABS3;ARGABSPL;ARGIO3;ARGIOPL;INFM;MASC;PAST;IND	eus
V;ARGABS3;ARGABSPL;ARGIO3;ARGIOPL;INFM;MASC;PAST;POT	eus
V;ARGABS3;ARGABSPL;ARGIO3;ARGIOPL;INFM;MASC;PRES;IND	eus
V;ARGABS3;ARGABSPL;ARGIO3;ARGIOPL;INFM;MASC;PRES;POT	eus
V;ARGABS3;ARGABSPL;ARGIO3;ARGIOPL;PAST;IND	eus
V;ARGABS3;ARGABSPL;ARGIO3;ARGIOPL;PAST;POT	eus
V;ARGABS3;ARGABSPL;ARGIO3;ARGIOPL;PRES;IND	eus
V;ARGABS3;ARGABSPL;ARGIO3;ARGIOPL;PRES;POT	eus
V;ARGABS3;ARGABSPL;ARGIO3;ARGIOSG;HYP;IND	eus
V;ARGABS3;ARGABSPL;ARGIO3;ARGIOSG;HYP;POT	eus
V;ARGABS3;ARGABSPL;ARGIO3;ARGIOSG;IMP	eus
V;ARGABS3;ARGABSPL;ARGIO3;ARGIOSG;INFM;FEM;PAST;IND	eus
V;ARGABS3;ARGABSPL;ARGIO3;ARGIOSG;INFM;FEM;PAST;POT	eus
V;ARGABS3;ARGABSPL;ARGIO3;ARGIOSG;INFM;FEM;PRES;IND	eus
V;ARGABS3;ARGABSPL;ARGIO3;ARGIOSG;INFM;MASC;PAST;IND	eus
V;ARGABS3;ARGABSPL;ARGIO3;ARGIOSG;INFM;MASC;PAST;POT	eus
V;ARGABS3;ARGABSPL;ARGIO3;ARGIOSG;INFM;MASC;PRES;IND	eus
V;ARGABS3;ARGABSPL;ARGIO3;ARGIOSG;INFM;MASC;PRES;POT	eus
V;ARGABS3;ARGABSPL;ARGIO3;ARGIOSG;PAST;IND	eus
V;ARGABS3;ARGABSPL;ARGIO3;ARGIOSG;PAST;POT	eus
V;ARGABS3;ARGABSPL;ARGIO3;ARGIOSG;PRES;IND	eus
V;ARGABS3;ARGABSPL;ARGIO3;ARGIOSG;PRES;POT	eus
V;ARGABS3;ARGABSPL;HYP;IND	eus
V;ARGABS3;ARGABSPL;HYP;POT	eus
V;ARGABS3;ARGABSPL;IMP	eus
V;ARGABS3;ARGABSPL;INFM;FEM;PAST;IND	eus
V;ARGABS3;ARGABSPL;INFM;FEM;PAST;POT	eus
V;ARGABS3;ARGABSPL;INFM;FEM;PRES;IND	eus
V;ARGABS3;ARGABSPL;INFM;FEM;PRES;POT	eus
V;ARGABS3;ARGABSPL;INFM;MASC;PAST;IND	eus
V;ARGABS3;ARGABSPL;INFM;MASC;PAST;POT	eus
V;ARGABS3;ARGABSPL;INFM;MASC;PRES;IND	eus
V;ARGABS3;ARGABSPL;INFM;MASC;PRES;POT	eus
V;ARGABS3;ARGABSPL;PAST;IND	eus
V;ARGABS3;ARGABSPL;PAST;POT	eus
V;ARGABS3;ARGABSPL;PRES;IND	eus
V;ARGABS3;ARGABSPL;PRES;POT	eus
V;ARGABS3;ARGABSSG;ARGERG1;ARGERGPL;ARGIO2;ARGIOPL;HYP;IND	eus
V;ARGABS3;ARGABSSG;ARGERG1;ARGERGPL;ARGIO2;ARGIOPL;HYP;POT	eus
V;ARGABS3;ARGABSSG;ARGERG1;ARGERGPL;ARGIO2;ARGIOPL;PAST;IND	eus
V;ARGABS3;ARGABSSG;ARGERG1;ARGERGPL;ARGIO2;ARGIOPL;PAST;POT	eus
V;ARGABS3;ARGABSSG;ARGERG1;ARGERGPL;ARGIO2;ARGIOPL;PRES;IND	eus
V;ARGABS3;ARGABSSG;ARGERG1;ARGERGPL;ARGIO2;ARGIOSG;HYP;IND	eus
V;ARGABS3;ARGABSSG;ARGERG1;ARGERGPL;ARGIO2;ARGIOSG;HYP;POT	eus
V;ARGABS3;ARGABSSG;ARGERG1;ARGERGPL;ARGIO2;ARGIOSG;PAST;IND	eus
V;ARGABS3;ARGABSSG;ARGERG1;ARGERGPL;ARGIO2;ARGIOSG;PAST;POT	eus
V;ARGABS3;ARGABSSG;ARGERG1;ARGERGPL;ARGIO2;ARGIOSG;PRES;IND	eus
V;ARGABS3;ARGABSSG;ARGERG1;ARGERGPL;ARGIO3;ARGIOPL;HYP;IND	eus
V;ARGABS3;ARGABSSG;ARGERG1;ARGERGPL;ARGIO3;ARGIOPL;HYP;POT	eus
V;ARGABS3;ARGABSSG;ARGERG1;ARGERGPL;ARGIO3;ARGIOPL;INFM;FEM;PAST;IND	eus
V;ARGABS3;ARGABSSG;ARGERG1;ARGERGPL;ARGIO3;ARGIOPL;INFM;FEM;PRES;IND	eus
V;ARGABS3;ARGABSSG;ARGERG1;ARGERGPL;ARGIO3;ARGIOPL;INFM;MASC;PAST;IND	eus
V;ARGABS3;ARGABSSG;ARGERG1;ARGERGPL;ARGIO3;ARGIOPL;INFM;MASC;PRES;IND	eus
V;ARGABS3;ARGABSSG;ARGERG1;ARGERGPL;ARGIO3;ARGIOPL;PAST;IND	eus
V;ARGABS3;ARGABSSG;ARGERG1;ARGERGPL;ARGIO3;ARGIOPL;PAST;POT	eus
V;ARGABS3;ARGABSSG;ARGERG1;ARGERGPL;ARGIO3;ARGIOPL;PRES;IND	eus
V;ARGABS3;ARGABSSG;ARGERG1;ARGERGPL;ARGIO3;ARGIOSG;HYP;IND	eus
V;ARGABS3;ARGABSSG;ARGERG1;ARGERGPL;ARGIO3;ARGIOSG;HYP;POT	eus
V;ARGABS3;ARGABSSG;ARGERG1;ARGERGPL;ARGIO3;ARGIOSG;INFM;FEM;PAST;IND	eus
V;ARGABS3;ARGABSSG;ARGERG1;ARGERGPL;ARGIO3;ARGIOSG;INFM;FEM;PRES;IND	eus
V;ARGABS3;ARGABSSG;ARGERG1;ARGERGPL;ARGIO3;ARGIOSG;INFM;MASC;PAST;IND	eus
V;ARGABS3;ARGABSSG;ARGERG1;ARGERGPL;ARGIO3;ARGIOSG;INFM;MASC;PRES;IND	eus
V;ARGABS3;ARGABSSG;ARGERG1;ARGERGPL;ARGIO3;ARGIOSG;PAST;IND	eus
V;ARGABS3;ARGABSSG;ARGERG1;ARGERGPL;ARGIO3;ARGIOSG;PAST;POT	eus
V;ARGABS3;ARGABSSG;ARGERG1;ARGERGPL;ARGIO3;ARGIOSG;PRES;IND	eus
V;ARGABS3;ARGABSSG;ARGERG1;ARGERGPL;HYP;IND	eus
V;ARGABS3;ARGABSSG;ARGERG1;ARGERGPL;HYP;POT	eus
V;ARGABS3;ARGABSSG;ARGERG1;ARGERGPL;INFM;FEM;PAST;IND	eus
V;ARGABS3;ARGABSSG;ARGERG1;ARGERGPL;INFM;FEM;PRES;IND	eus
V;ARGABS3;ARGABSSG;ARGERG1;ARGERGPL;INFM;MASC;PAST;IND	eus
V;ARGABS3;ARGABSSG;ARGERG1;ARGERGPL;INFM;MASC;PRES;IND	eus
V;ARGABS3;ARGABSSG;ARGERG1;ARGERGPL;PAST;IND	eus
V;ARGABS3;ARGABSSG;ARGERG1;ARGERGPL;PAST;POT	eus
V;ARGABS3;ARGABSSG;ARGERG1;ARGERGPL;PRES;IND	eus
V;ARGABS3;ARGABSSG;ARGERG1;ARGERGSG;ARGIO2;ARGIOPL;HYP;IND	eus
V;ARGABS3;ARGABSSG;ARGERG1;ARGERGSG;ARGIO2;ARGIOPL;HYP;POT	eus
V;ARGABS3;ARGABSSG;ARGERG1;ARGERGSG;ARGIO2;ARGIOPL;PAST;IND	eus
V;ARGABS3;ARGABSSG;ARGERG1;ARGERGSG;ARGIO2;ARGIOPL;PAST;POT	eus
V;ARGABS3;ARGABSSG;ARGERG1;ARGERGSG;ARGIO2;ARGIOPL;PRES;IND	eus
V;ARGABS3;ARGABSSG;ARGERG1;ARGERGSG;ARGIO2;ARGIOSG;ARGIOINFM;ARGIOFEM;PRES;IND	eus
V;ARGABS3;ARGABSSG;ARGERG1;ARGERGSG;ARGIO2;ARGIOSG;ARGIOINFM;ARGIOMASC;PRES;IND	eus
V;ARGABS3;ARGABSSG;ARGERG1;ARGERGSG;ARGIO2;ARGIOSG;HYP;IND	eus
V;ARGABS3;ARGABSSG;ARGERG1;ARGERGSG;ARGIO2;ARGIOSG;HYP;POT	eus
V;ARGABS3;ARGABSSG;ARGERG1;ARGERGSG;ARGIO2;ARGIOSG;PAST;IND	eus
V;ARGABS3;ARGABSSG;ARGERG1;ARGERGSG;ARGIO2;ARGIOSG;PAST;POT	eus
V;ARGABS3;ARGABSSG;ARGERG1;ARGERGSG;ARGIO2;ARGIOSG;PRES;IND	eus
V;ARGABS3;ARGABSSG;ARGERG1;ARGERGSG;ARGIO3;ARGIOPL;HYP;IND	eus
V;ARGABS3;ARGABSSG;ARGERG1;ARGERGSG;ARGIO3;ARGIOPL;HYP;POT	eus
V;ARGABS3;ARGABSSG;ARGERG1;ARGERGSG;ARGIO3;ARGIOPL;INFM;FEM;PAST;IND	eus
V;ARGABS3;ARGABSSG;ARGERG1;ARGERGSG;ARGIO3;ARGIOPL;INFM;FEM;PRES;IND	eus
V;ARGABS3;ARGABSSG;ARGERG1;ARGERGSG;ARGIO3;ARGIOPL;INFM;MASC;PAST;IND	eus
V;ARGABS3;ARGABSSG;ARGERG1;ARGERGSG;ARGIO3;ARGIOPL;INFM;MASC;PRES;IND	eus
V;ARGABS3;ARGABSSG;ARGERG1;ARGERGSG;ARGIO3;ARGIOPL;PAST;IND	eus
V;ARGABS3;ARGABSSG;ARGERG1;ARGERGSG;ARGIO3;ARGIOPL;PAST;POT	eus
V;ARGABS3;ARGABSSG;ARGERG1;ARGERGSG;ARGIO3;ARGIOPL;PRES;IND	eus
V;ARGABS3;ARGABSSG;ARGERG1;ARGERGSG;ARGIO3;ARGIOSG;HYP;IND	eus
V;ARGABS3;ARGABSSG;ARGERG1;ARGERGSG;ARGIO3;ARGIOSG;HYP;POT	eus
V;ARGABS3;ARGABSSG;ARGERG1;ARGERGSG;ARGIO3;ARGIOSG;INFM;FEM;PAST;IND	eus
V;ARGABS3;ARGABSSG;ARGERG1;ARGERGSG;ARGIO3;ARGIOSG;INFM;FEM;PRES;IND	eus
V;ARGABS3;ARGABSSG;ARGERG1;ARGERGSG;ARGIO3;ARGIOSG;INFM;MASC;PAST;IND	eus
V;ARGABS3;ARGABSSG;ARGERG1;ARGERGSG;ARGIO3;ARGIOSG;INFM;MASC;PRES;IND	eus
V;ARGABS3;ARGABSSG;ARGERG1;ARGERGSG;ARGIO3;ARGIOSG;PAST;IND	eus
V;ARGABS3;ARGABSSG;ARGERG1;ARGERGSG;ARGIO3;ARGIOSG;PAST;POT	eus
V;ARGABS3;ARGABSSG;ARGERG1;ARGERGSG;ARGIO3;ARGIOSG;PRES;IND	eus
V;ARGABS3;ARGABSSG;ARGERG1;ARGERGSG;HYP;IND	eus
V;ARGABS3;ARGABSSG;ARGERG1;ARGERGSG;HYP;POT	eus
V;ARGABS3;ARGABSSG;ARGERG1;ARGERGSG;INFM;FEM;PAST;IND	eus
V;ARGABS3;ARGABSSG;ARGERG1;ARGERGSG;INFM;FEM;PRES;IND	eus
V;ARGABS3;ARGABSSG;ARGERG1;ARGERGSG;INFM;MASC;PAST;IND	eus
V;ARGABS3;ARGABSSG;ARGERG1;ARGERGSG;INFM;MASC;PRES;IND	eus
V;ARGABS3;ARGABSSG;ARGERG1;ARGERGSG;PAST;IND	eus
V;ARGABS3;ARGABSSG;ARGERG1;ARGERGSG;PAST;POT	eus
V;ARGABS3;ARGABSSG;ARGERG1;ARGERGSG;PRES;IND	eus
V;ARGABS3;ARGABSSG;ARGERG2;ARGERGPL;ARGIO1;ARGIOPL;HYP;IND	eus
V;ARGABS3;ARGABSSG;ARGERG2;ARGERGPL;ARGIO1;ARGIOPL;HYP;POT	eus
V;ARGABS3;ARGABSSG;ARGERG2;ARGERGPL;ARGIO1;ARGIOPL;IMP	eus
V;ARGABS3;ARGABSSG;ARGERG2;ARGERGPL;ARGIO1;ARGIOPL;PAST;IND	eus
V;ARGABS3;ARGABSSG;ARGERG2;ARGERGPL;ARGIO1;ARGIOPL;PAST;POT	eus
V;ARGABS3;ARGABSSG;ARGERG2;ARGERGPL;ARGIO1;ARGIOSG;HYP;IND	eus
V;ARGABS3;ARGABSSG;ARGERG2;ARGERGPL;ARGIO1;ARGIOSG;HYP;POT	eus
V;ARGABS3;ARGABSSG;ARGERG2;ARGERGPL;ARGIO1;ARGIOSG;IMP	eus
V;ARGABS3;ARGABSSG;ARGERG2;ARGERGPL;ARGIO1;ARGIOSG;PAST;IND	eus
V;ARGABS3;ARGABSSG;ARGERG2;ARGERGPL;ARGIO1;ARGIOSG;PAST;POT	eus
V;ARGABS3;ARGABSSG;ARGERG2;ARGERGPL;ARGIO1;ARGIOSG;PRES;IND	eus
V;ARGABS3;ARGABSSG;ARGERG2;ARGERGPL;ARGIO3;ARGIOPL;HYP;IND	eus
V;ARGABS3;ARGABSSG;ARGERG2;ARGERGPL;ARGIO3;ARGIOPL;HYP;POT	eus
V;ARGABS3;ARGABSSG;ARGERG2;ARGERGPL;ARGIO3;ARGIOPL;IMP	eus
V;ARGABS3;ARGABSSG;ARGERG2;ARGERGPL;ARGIO3;ARGIOPL;PAST;IND	eus
V;ARGABS3;ARGABSSG;ARGERG2;ARGERGPL;ARGIO3;ARGIOPL;PAST;POT	eus
V;ARGABS3;ARGABSSG;ARGERG2;ARGERGPL;ARGIO3;ARGIOPL;PRES;IND	eus
V;ARGABS3;ARGABSSG;ARGERG2;ARGERGPL;ARGIO3;ARGIOSG;HYP;IND	eus
V;ARGABS3;ARGABSSG;ARGERG2;ARGERGPL;ARGIO3;ARGIOSG;HYP;POT	eus
V;ARGABS3;ARGABSSG;ARGERG2;ARGERGPL;ARGIO3;ARGIOSG;IMP	eus
V;ARGABS3;ARGABSSG;ARGERG2;ARGERGPL;ARGIO3;ARGIOSG;PAST;IND	eus
V;ARGABS3;ARGABSSG;ARGERG2;ARGERGPL;ARGIO3;ARGIOSG;PAST;POT	eus
V;ARGABS3;ARGABSSG;ARGERG2;ARGERGPL;ARGIO3;ARGIOSG;PRES;IND	eus
V;ARGABS3;ARGABSSG;ARGERG2;ARGERGPL;HYP;IND	eus
V;ARGABS3;ARGABSSG;ARGERG2;ARGERGPL;HYP;POT	eus
V;ARGABS3;ARGABSSG;ARGERG2;ARGERGPL;IMP	eus
V;ARGABS3;ARGABSSG;ARGERG2;ARGERGPL;PAST;IND	eus
V;ARGABS3;ARGABSSG;ARGERG2;ARGERGPL;PAST;POT	eus
V;ARGABS3;ARGABSSG;ARGERG2;ARGERGPL;PRES;IND	eus
V;ARGABS3;ARGABSSG;ARGERG2;ARGERGSG;ARGERGINFM;ARGERGFEM;ARGIO1;ARGIOPL;IMP	eus
V;ARGABS3;ARGABSSG;ARGERG2;ARGERGSG;ARGERGINFM;ARGERGFEM;ARGIO1;ARGIOSG;IMP	eus
V;ARGABS3;ARGABSSG;ARGERG2;ARGERGSG;ARGERGINFM;ARGERGFEM;ARGIO1;ARGIOSG;PRES;IND	eus
V;ARGABS3;ARGABSSG;ARGERG2;ARGERGSG;ARGERGINFM;ARGERGFEM;ARGIO3;ARGIOPL;IMP	eus
V;ARGABS3;ARGABSSG;ARGERG2;ARGERGSG;ARGERGINFM;ARGERGFEM;ARGIO3;ARGIOPL;PRES;IND	eus
V;ARGABS3;ARGABSSG;ARGERG2;ARGERGSG;ARGERGINFM;ARGERGFEM;ARGIO3;ARGIOSG;IMP	eus
V;ARGABS3;ARGABSSG;ARGERG2;ARGERGSG;ARGERGINFM;ARGERGFEM;ARGIO3;ARGIOSG;PRES;IND	eus
V;ARGABS3;ARGABSSG;ARGERG2;ARGERGSG;ARGERGINFM;ARGERGFEM;IMP	eus
V;ARGABS3;ARGABSSG;ARGERG2;ARGERGSG;ARGERGINFM;ARGERGFEM;PRES;IND	eus
V;ARGABS3;ARGABSSG;ARGERG2;ARGERGSG;ARGERGINFM;ARGERGMASC;ARGIO1;ARGIOPL;IMP	eus
V;ARGABS3;ARGABSSG;ARGERG2;ARGERGSG;ARGERGINFM;ARGERGMASC;ARGIO1;ARGIOSG;IMP	eus
V;ARGABS3;ARGABSSG;ARGERG2;ARGERGSG;ARGERGINFM;ARGERGMASC;ARGIO1;ARGIOSG;PRES;IND	eus
V;ARGABS3;ARGABSSG;ARGERG2;ARGERGSG;ARGERGINFM;ARGERGMASC;ARGIO3;ARGIOPL;IMP	eus
V;ARGABS3;ARGABSSG;ARGERG2;ARGERGSG;ARGERGINFM;ARGERGMASC;ARGIO3;ARGIOPL;PRES;IND	eus
V;ARGABS3;ARGABSSG;ARGERG2;ARGERGSG;ARGERGINFM;ARGERGMASC;ARGIO3;ARGIOSG;IMP	eus
V;ARGABS3;ARGABSSG;ARGERG2;ARGERGSG;ARGERGINFM;ARGERGMASC;ARGIO3;ARGIOSG;PRES;IND	eus
V;ARGABS3;ARGABSSG;ARGERG2;ARGERGSG;ARGERGINFM;ARGERGMASC;IMP	eus
V;ARGABS3;ARGABSSG;ARGERG2;ARGERGSG;ARGERGINFM;ARGERGMASC;PRES;IND	eus
V;ARGABS3;ARGABSSG;ARGERG2;ARGERGSG;ARGERGINFM;ARGIO1;ARGIOSG;HYP;IND	eus
V;ARGABS3;ARGABSSG;ARGERG2;ARGERGSG;ARGERGINFM;ARGIO1;ARGIOSG;PAST;IND	eus
V;ARGABS3;ARGABSSG;ARGERG2;ARGERGSG;ARGERGINFM;ARGIO1;ARGIOSG;PAST;POT	eus
V;ARGABS3;ARGABSSG;ARGERG2;ARGERGSG;ARGERGINFM;ARGIO3;ARGIOPL;HYP;IND	eus
V;ARGABS3;ARGABSSG;ARGERG2;ARGERGSG;ARGERGINFM;ARGIO3;ARGIOPL;HYP;POT	eus
V;ARGABS3;ARGABSSG;ARGERG2;ARGERGSG;ARGERGINFM;ARGIO3;ARGIOPL;PAST;IND	eus
V;ARGABS3;ARGABSSG;ARGERG2;ARGERGSG;ARGERGINFM;ARGIO3;ARGIOPL;PAST;POT	eus
V;ARGABS3;ARGABSSG;ARGERG2;ARGERGSG;ARGERGINFM;ARGIO3;ARGIOSG;HYP;IND	eus
V;ARGABS3;ARGABSSG;ARGERG2;ARGERGSG;ARGERGINFM;ARGIO3;ARGIOSG;HYP;POT	eus
V;ARGABS3;ARGABSSG;ARGERG2;ARGERGSG;ARGERGINFM;ARGIO3;ARGIOSG;PAST;IND	eus
V;ARGABS3;ARGABSSG;ARGERG2;ARGERGSG;ARGERGINFM;ARGIO3;ARGIOSG;PAST;POT	eus
V;ARGABS3;ARGABSSG;ARGERG2;ARGERGSG;ARGERGINFM;HYP;IND	eus
V;ARGABS3;ARGABSSG;ARGERG2;ARGERGSG;ARGERGINFM;HYP;POT	eus
V;ARGABS3;ARGABSSG;ARGERG2;ARGERGSG;ARGERGINFM;PAST;IND	eus
V;ARGABS3;ARGABSSG;ARGERG2;ARGERGSG;ARGERGINFM;PAST;POT	eus
V;ARGABS3;ARGABSSG;ARGERG2;ARGERGSG;ARGIO1;ARGIOPL;IMP	eus
V;ARGABS3;ARGABSSG;ARGERG2;ARGERGSG;ARGIO1;ARGIOSG;HYP;IND	eus
V;ARGABS3;ARGABSSG;ARGERG2;ARGERGSG;ARGIO1;ARGIOSG;HYP;POT	eus
V;ARGABS3;ARGABSSG;ARGERG2;ARGERGSG;ARGIO1;ARGIOSG;IMP	eus
V;ARGABS3;ARGABSSG;ARGERG2;ARGERGSG;ARGIO1;ARGIOSG;PAST;IND	eus
V;ARGABS3;ARGABSSG;ARGERG2;ARGERGSG;ARGIO1;ARGIOSG;PAST;POT	eus
V;ARGABS3;ARGABSSG;ARGERG2;ARGERGSG;ARGIO1;ARGIOSG;PRES;IND	eus
V;ARGABS3;ARGABSSG;ARGERG2;ARGERGSG;ARGIO3;ARGIOPL;HYP;IND	eus
V;ARGABS3;ARGABSSG;ARGERG2;ARGERGSG;ARGIO3;ARGIOPL;HYP;POT	eus
V;ARGABS3;ARGABSSG;ARGERG2;ARGERGSG;ARGIO3;ARGIOPL;IMP	eus
V;ARGABS3;ARGABSSG;ARGERG2;ARGERGSG;ARGIO3;ARGIOPL;PAST;IND	eus
V;ARGABS3;ARGABSSG;ARGERG2;ARGERGSG;ARGIO3;ARGIOPL;PAST;POT	eus
V;ARGABS3;ARGABSSG;ARGERG2;ARGERGSG;ARGIO3;ARGIOPL;PRES;IND	eus
V;ARGABS3;ARGABSSG;ARGERG2;ARGERGSG;ARGIO3;ARGIOSG;HYP;IND	eus
V;ARGABS3;ARGABSSG;ARGERG2;ARGERGSG;ARGIO3;ARGIOSG;HYP;POT	eus
V;ARGABS3;ARGABSSG;ARGERG2;ARGERGSG;ARGIO3;ARGIOSG;IMP	eus
V;ARGABS3;ARGABSSG;ARGERG2;ARGERGSG;ARGIO3;ARGIOSG;PAST;IND	eus
V;ARGABS3;ARGABSSG;ARGERG2;ARGERGSG;ARGIO3;ARGIOSG;PAST;POT	eus
V;ARGABS3;ARGABSSG;ARGERG2;ARGERGSG;ARGIO3;ARGIOSG;PRES;IND	eus
V;ARGABS3;ARGABSSG;ARGERG2;ARGERGSG;HYP;IND	eus
V;ARGABS3;ARGABSSG;ARGERG2;ARGERGSG;HYP;POT	eus
V;ARGABS3;ARGABSSG;ARGERG2;ARGERGSG;IMP	eus
V;ARGABS3;ARGABSSG;ARGERG2;ARGERGSG;PAST;IND	eus
V;ARGABS3;ARGABSSG;ARGERG2;ARGERGSG;PAST;POT	eus
V;ARGABS3;ARGABSSG;ARGERG2;ARGERGSG;PRES;IND	eus
V;ARGABS3;ARGABSSG;ARGERG3;ARGERGPL;ARGIO1;ARGIOPL;HYP;IND	eus
V;ARGABS3;ARGABSSG;ARGERG3;ARGERGPL;ARGIO1;ARGIOPL;HYP;POT	eus
V;ARGABS3;ARGABSSG;ARGERG3;ARGERGPL;ARGIO1;ARGIOPL;IMP	eus
V;ARGABS3;ARGABSSG;ARGERG3;ARGERGPL;ARGIO1;ARGIOPL;INFM;FEM;PAST;IND	eus
V;ARGABS3;ARGABSSG;ARGERG3;ARGERGPL;ARGIO1;ARGIOPL;INFM;FEM;PRES;IND	eus
V;ARGABS3;ARGABSSG;ARGERG3;ARGERGPL;ARGIO1;ARGIOPL;INFM;MASC;PAST;IND	eus
V;ARGABS3;ARGABSSG;ARGERG3;ARGERGPL;ARGIO1;ARGIOPL;INFM;MASC;PRES;IND	eus
V;ARGABS3;ARGABSSG;ARGERG3;ARGERGPL;ARGIO1;ARGIOPL;PAST;IND	eus
V;ARGABS3;ARGABSSG;ARGERG3;ARGERGPL;ARGIO1;ARGIOPL;PAST;POT	eus
V;ARGABS3;ARGABSSG;ARGERG3;ARGERGPL;ARGIO1;ARGIOPL;PRES;IND	eus
V;ARGABS3;ARGABSSG;ARGERG3;ARGERGPL;ARGIO1;ARGIOSG;HYP;IND	eus
V;ARGABS3;ARGABSSG;ARGERG3;ARGERGPL;ARGIO1;ARGIOSG;HYP;POT	eus
V;ARGABS3;ARGABSSG;ARGERG3;ARGERGPL;ARGIO1;ARGIOSG;IMP	eus
V;ARGABS3;ARGABSSG;ARGERG3;ARGERGPL;ARGIO1;ARGIOSG;INFM;FEM;PAST;IND	eus
V;ARGABS3;ARGABSSG;ARGERG3;ARGERGPL;ARGIO1;ARGIOSG;INFM;FEM;PRES;IND	eus
V;ARGABS3;ARGABSSG;ARGERG3;ARGERGPL;ARGIO1;ARGIOSG;INFM;MASC;PAST;IND	eus
V;ARGABS3;ARGABSSG;ARGERG3;ARGERGPL;ARGIO1;ARGIOSG;INFM;MASC;PRES;IND	eus
V;ARGABS3;ARGABSSG;ARGERG3;ARGERGPL;ARGIO1;ARGIOSG;PAST;IND	eus
V;ARGABS3;ARGABSSG;ARGERG3;ARGERGPL;ARGIO1;ARGIOSG;PAST;POT	eus
V;ARGABS3;ARGABSSG;ARGERG3;ARGERGPL;ARGIO1;ARGIOSG;PRES;IND	eus
V;ARGABS3;ARGABSSG;ARGERG3;ARGERGPL;ARGIO2;ARGIOPL;HYP;IND	eus
V;ARGABS3;ARGABSSG;ARGERG3;ARGERGPL;ARGIO2;ARGIOPL;HYP;POT	eus
V;ARGABS3;ARGABSSG;ARGERG3;ARGERGPL;ARGIO2;ARGIOPL;IMP	eus
V;ARGABS3;ARGABSSG;ARGERG3;ARGERGPL;ARGIO2;ARGIOPL;PAST;IND	eus
V;ARGABS3;ARGABSSG;ARGERG3;ARGERGPL;ARGIO2;ARGIOPL;PAST;POT	eus
V;ARGABS3;ARGABSSG;ARGERG3;ARGERGPL;ARGIO2;ARGIOPL;PRES;IND	eus
V;ARGABS3;ARGABSSG;ARGERG3;ARGERGPL;ARGIO2;ARGIOSG;ARGIOINFM;ARGIOFEM;HYP;IND	eus
V;ARGABS3;ARGABSSG;ARGERG3;ARGERGPL;ARGIO2;ARGIOSG;ARGIOINFM;ARGIOFEM;HYP;POT	eus
V;ARGABS3;ARGABSSG;ARGERG3;ARGERGPL;ARGIO2;ARGIOSG;ARGIOINFM;ARGIOFEM;IMP	eus
V;ARGABS3;ARGABSSG;ARGERG3;ARGERGPL;ARGIO2;ARGIOSG;ARGIOINFM;ARGIOFEM;PAST;IND	eus
V;ARGABS3;ARGABSSG;ARGERG3;ARGERGPL;ARGIO2;ARGIOSG;ARGIOINFM;ARGIOFEM;PAST;POT	eus
V;ARGABS3;ARGABSSG;ARGERG3;ARGERGPL;ARGIO2;ARGIOSG;ARGIOINFM;ARGIOFEM;PRES;IND	eus
V;ARGABS3;ARGABSSG;ARGERG3;ARGERGPL;ARGIO2;ARGIOSG;ARGIOINFM;ARGIOMASC;HYP;IND	eus
V;ARGABS3;ARGABSSG;ARGERG3;ARGERGPL;ARGIO2;ARGIOSG;ARGIOINFM;ARGIOMASC;HYP;POT	eus
V;ARGABS3;ARGABSSG;ARGERG3;ARGERGPL;ARGIO2;ARGIOSG;ARGIOINFM;ARGIOMASC;IMP	eus
V;ARGABS3;ARGABSSG;ARGERG3;ARGERGPL;ARGIO2;ARGIOSG;ARGIOINFM;ARGIOMASC;PAST;IND	eus
V;ARGABS3;ARGABSSG;ARGERG3;ARGERGPL;ARGIO2;ARGIOSG;ARGIOINFM;ARGIOMASC;PAST;POT	eus
V;ARGABS3;ARGABSSG;ARGERG3;ARGERGPL;ARGIO2;ARGIOSG;ARGIOINFM;ARGIOMASC;PRES;IND	eus
V;ARGABS3;ARGABSSG;ARGERG3;ARGERGPL;ARGIO2;ARGIOSG;HYP;IND	eus
V;ARGABS3;ARGABSSG;ARGERG3;ARGERGPL;ARGIO2;ARGIOSG;HYP;POT	eus
V;ARGABS3;ARGABSSG;ARGERG3;ARGERGPL;ARGIO2;ARGIOSG;IMP	eus
V;ARGABS3;ARGABSSG;ARGERG3;ARGERGPL;ARGIO2;ARGIOSG;PAST;IND	eus
V;ARGABS3;ARGABSSG;ARGERG3;ARGERGPL;ARGIO2;ARGIOSG;PAST;POT	eus
V;ARGABS3;ARGABSSG;ARGERG3;ARGERGPL;ARGIO2;ARGIOSG;PRES;IND	eus
V;ARGABS3;ARGABSSG;ARGERG3;ARGERGPL;ARGIO3;ARGIOPL;HYP;IND	eus
V;ARGABS3;ARGABSSG;ARGERG3;ARGERGPL;ARGIO3;ARGIOPL;HYP;POT	eus
V;ARGABS3;ARGABSSG;ARGERG3;ARGERGPL;ARGIO3;ARGIOPL;IMP	eus
V;ARGABS3;ARGABSSG;ARGERG3;ARGERGPL;ARGIO3;ARGIOPL;INFM;FEM;PAST;IND	eus
V;ARGABS3;ARGABSSG;ARGERG3;ARGERGPL;ARGIO3;ARGIOPL;INFM;FEM;PRES;IND	eus
V;ARGABS3;ARGABSSG;ARGERG3;ARGERGPL;ARGIO3;ARGIOPL;INFM;MASC;PAST;IND	eus
V;ARGABS3;ARGABSSG;ARGERG3;ARGERGPL;ARGIO3;ARGIOPL;INFM;MASC;PRES;IND	eus
V;ARGABS3;ARGABSSG;ARGERG3;ARGERGPL;ARGIO3;ARGIOPL;PAST;IND	eus
V;ARGABS3;ARGABSSG;ARGERG3;ARGERGPL;ARGIO3;ARGIOPL;PAST;POT	eus
V;ARGABS3;ARGABSSG;ARGERG3;ARGERGPL;ARGIO3;ARGIOPL;PRES;IND	eus
V;ARGABS3;ARGABSSG;ARGERG3;ARGERGPL;ARGIO3;ARGIOSG;HYP;IND	eus
V;ARGABS3;ARGABSSG;ARGERG3;ARGERGPL;ARGIO3;ARGIOSG;HYP;POT	eus
V;ARGABS3;ARGABSSG;ARGERG3;ARGERGPL;ARGIO3;ARGIOSG;IMP	eus
V;ARGABS3;ARGABSSG;ARGERG3;ARGERGPL;ARGIO3;ARGIOSG;INFM;FEM;PAST;IND	eus
V;ARGABS3;ARGABSSG;ARGERG3;ARGERGPL;ARGIO3;ARGIOSG;INFM;FEM;PRES;IND	eus
V;ARGABS3;ARGABSSG;ARGERG3;ARGERGPL;ARGIO3;ARGIOSG;INFM;MASC;PAST;IND	eus
V;ARGABS3;ARGABSSG;ARGERG3;ARGERGPL;ARGIO3;ARGIOSG;INFM;MASC;PRES;IND	eus
V;ARGABS3;ARGABSSG;ARGERG3;ARGERGPL;ARGIO3;ARGIOSG;PAST;IND	eus
V;ARGABS3;ARGABSSG;ARGERG3;ARGERGPL;ARGIO3;ARGIOSG;PAST;POT	eus
V;ARGABS3;ARGABSSG;ARGERG3;ARGERGPL;ARGIO3;ARGIOSG;PRES;IND	eus
V;ARGABS3;ARGABSSG;ARGERG3;ARGERGPL;HYP;IND	eus
V;ARGABS3;ARGABSSG;ARGERG3;ARGERGPL;HYP;POT	eus
V;ARGABS3;ARGABSSG;ARGERG3;ARGERGPL;IMP	eus
V;ARGABS3;ARGABSSG;ARGERG3;ARGERGPL;INFM;FEM;PAST;IND	eus
V;ARGABS3;ARGABSSG;ARGERG3;ARGERGPL;INFM;FEM;PRES;IND	eus
V;ARGABS3;ARGABSSG;ARGERG3;ARGERGPL;INFM;MASC;PAST;IND	eus
V;ARGABS3;ARGABSSG;ARGERG3;ARGERGPL;INFM;MASC;PRES;IND	eus
V;ARGABS3;ARGABSSG;ARGERG3;ARGERGPL;PAST;IND	eus
V;ARGABS3;ARGABSSG;ARGERG3;ARGERGPL;PAST;POT	eus
V;ARGABS3;ARGABSSG;ARGERG3;ARGERGPL;PRES;IND	eus
V;ARGABS3;ARGABSSG;ARGERG3;ARGERGSG;ARGIO1;ARGIOPL;IMP	eus
V;ARGABS3;ARGABSSG;ARGERG3;ARGERGSG;ARGIO1;ARGIOPL;PAST;POT	eus
V;ARGABS3;ARGABSSG;ARGERG3;ARGERGSG;ARGIO1;ARGIOSG;HYP;IND	eus
V;ARGABS3;ARGABSSG;ARGERG3;ARGERGSG;ARGIO1;ARGIOSG;HYP;POT	eus
V;ARGABS3;ARGABSSG;ARGERG3;ARGERGSG;ARGIO1;ARGIOSG;IMP	eus
V;ARGABS3;ARGABSSG;ARGERG3;ARGERGSG;ARGIO1;ARGIOSG;INFM;FEM;PAST;IND	eus
V;ARGABS3;ARGABSSG;ARGERG3;ARGERGSG;ARGIO1;ARGIOSG;INFM;FEM;PRES;IND	eus
V;ARGABS3;ARGABSSG;ARGERG3;ARGERGSG;ARGIO1;ARGIOSG;INFM;MASC;PAST;IND	eus
V;ARGABS3;ARGABSSG;ARGERG3;ARGERGSG;ARGIO1;ARGIOSG;INFM;MASC;PRES;IND	eus
V;ARGABS3;ARGABSSG;ARGERG3;ARGERGSG;ARGIO1;ARGIOSG;PAST;IND	eus
V;ARGABS3;ARGABSSG;ARGERG3;ARGERGSG;ARGIO1;ARGIOSG;PAST;POT	eus
V;ARGABS3;ARGABSSG;ARGERG3;ARGERGSG;ARGIO1;ARGIOSG;PRES;IND	eus
V;ARGABS3;ARGABSSG;ARGERG3;ARGERGSG;ARGIO2;ARGIOPL;HYP;IND	eus
V;ARGABS3;ARGABSSG;ARGERG3;ARGERGSG;ARGIO2;ARGIOPL;HYP;POT	eus
V;ARGABS3;ARGABSSG;ARGERG3;ARGERGSG;ARGIO2;ARGIOPL;IMP	eus
V;ARGABS3;ARGABSSG;ARGERG3;ARGERGSG;ARGIO2;ARGIOPL;PAST;IND	eus
V;ARGABS3;ARGABSSG;ARGERG3;ARGERGSG;ARGIO2;ARGIOPL;PAST;POT	eus
V;ARGABS3;ARGABSSG;ARGERG3;ARGERGSG;ARGIO2;ARGIOPL;PRES;IND	eus
V;ARGABS3;ARGABSSG;ARGERG3;ARGERGSG;ARGIO2;ARGIOSG;ARGIOINFM;ARGIOFEM;IMP	eus
V;ARGABS3;ARGABSSG;ARGERG3;ARGERGSG;ARGIO2;ARGIOSG;ARGIOINFM;ARGIOMASC;HYP;IND	eus
V;ARGABS3;ARGABSSG;ARGERG3;ARGERGSG;ARGIO2;ARGIOSG;ARGIOINFM;ARGIOMASC;HYP;POT	eus
V;ARGABS3;ARGABSSG;ARGERG3;ARGERGSG;ARGIO2;ARGIOSG;ARGIOINFM;ARGIOMASC;IMP	eus
V;ARGABS3;ARGABSSG;ARGERG3;ARGERGSG;ARGIO2;ARGIOSG;ARGIOINFM;ARGIOMASC;PAST;IND	eus
V;ARGABS3;ARGABSSG;ARGERG3;ARGERGSG;ARGIO2;ARGIOSG;ARGIOINFM;ARGIOMASC;PAST;POT	eus
V;ARGABS3;ARGABSSG;ARGERG3;ARGERGSG;ARGIO2;ARGIOSG;ARGIOINFM;ARGIOMASC;PRES;IND	eus
V;ARGABS3;ARGABSSG;ARGERG3;ARGERGSG;ARGIO2;ARGIOSG;HYP;IND	eus
V;ARGABS3;ARGABSSG;ARGERG3;ARGERGSG;ARGIO2;ARGIOSG;HYP;POT	eus
V;ARGABS3;ARGABSSG;ARGERG3;ARGERGSG;ARGIO2;ARGIOSG;IMP	eus
V;ARGABS3;ARGABSSG;ARGERG3;ARGERGSG;ARGIO2;ARGIOSG;PAST;IND	eus
V;ARGABS3;ARGABSSG;ARGERG3;ARGERGSG;ARGIO2;ARGIOSG;PAST;POT	eus
V;ARGABS3;ARGABSSG;ARGERG3;ARGERGSG;ARGIO2;ARGIOSG;PRES;IND	eus
V;ARGABS3;ARGABSSG;ARGERG3;ARGERGSG;ARGIO3;ARGIOPL;HYP;IND	eus
V;ARGABS3;ARGABSSG;ARGERG3;ARGERGSG;ARGIO3;ARGIOPL;HYP;POT	eus
V;ARGABS3;ARGABSSG;ARGERG3;ARGERGSG;ARGIO3;ARGIOPL;IMP	eus
V;ARGABS3;ARGABSSG;ARGERG3;ARGERGSG;ARGIO3;ARGIOPL;INFM;FEM;PAST;IND	eus
V;ARGABS3;ARGABSSG;ARGERG3;ARGERGSG;ARGIO3;ARGIOPL;INFM;FEM;PRES;IND	eus
V;ARGABS3;ARGABSSG;ARGERG3;ARGERGSG;ARGIO3;ARGIOPL;INFM;MASC;PAST;IND	eus
V;ARGABS3;ARGABSSG;ARGERG3;ARGERGSG;ARGIO3;ARGIOPL;INFM;MASC;PRES;IND	eus
V;ARGABS3;ARGABSSG;ARGERG3;ARGERGSG;ARGIO3;ARGIOPL;PAST;IND	eus
V;ARGABS3;ARGABSSG;ARGERG3;ARGERGSG;ARGIO3;ARGIOPL;PAST;POT	eus
V;ARGABS3;ARGABSSG;ARGERG3;ARGERGSG;ARGIO3;ARGIOPL;PRES;IND	eus
V;ARGABS3;ARGABSSG;ARGERG3;ARGERGSG;ARGIO3;ARGIOSG;HYP;IND	eus
V;ARGABS3;ARGABSSG;ARGERG3;ARGERGSG;ARGIO3;ARGIOSG;HYP;POT	eus
V;ARGABS3;ARGABSSG;ARGERG3;ARGERGSG;ARGIO3;ARGIOSG;IMP	eus
V;ARGABS3;ARGABSSG;ARGERG3;ARGERGSG;ARGIO3;ARGIOSG;INFM;FEM;PAST;IND	eus
V;ARGABS3;ARGABSSG;ARGERG3;ARGERGSG;ARGIO3;ARGIOSG;INFM;FEM;PRES;IND	eus
V;ARGABS3;ARGABSSG;ARGERG3;ARGERGSG;ARGIO3;ARGIOSG;INFM;MASC;PAST;IND	eus
V;ARGABS3;ARGABSSG;ARGERG3;ARGERGSG;ARGIO3;ARGIOSG;INFM;MASC;PRES;IND	eus
V;ARGABS3;ARGABSSG;ARGERG3;ARGERGSG;ARGIO3;ARGIOSG;PAST;IND	eus
V;ARGABS3;ARGABSSG;ARGERG3;ARGERGSG;ARGIO3;ARGIOSG;PAST;POT	eus
V;ARGABS3;ARGABSSG;ARGERG3;ARGERGSG;ARGIO3;ARGIOSG;PRES;IND	eus
V;ARGABS3;ARGABSSG;ARGERG3;ARGERGSG;HYP;IND	eus
V;ARGABS3;ARGABSSG;ARGERG3;ARGERGSG;HYP;POT	eus
V;ARGABS3;ARGABSSG;ARGERG3;ARGERGSG;IMP	eus
V;ARGABS3;ARGABSSG;ARGERG3;ARGERGSG;INFM;FEM;PAST;IND	eus
V;ARGABS3;ARGABSSG;ARGERG3;ARGERGSG;INFM;FEM;PRES;IND	eus
V;ARGABS3;ARGABSSG;ARGERG3;ARGERGSG;INFM;MASC;PAST;IND	eus
V;ARGABS3;ARGABSSG;ARGERG3;ARGERGSG;INFM;MASC;PRES;IND	eus
V;ARGABS3;ARGABSSG;ARGERG3;ARGERGSG;PAST;IND	eus
V;ARGABS3;ARGABSSG;ARGERG3;ARGERGSG;PAST;POT	eus
V;ARGABS3;ARGABSSG;ARGERG3;ARGERGSG;PRES;IND	eus
V;ARGABS3;ARGABSSG;ARGIO1;ARGIOPL;HYP;IND	eus
V;ARGABS3;ARGABSSG;ARGIO1;ARGIOPL;HYP;POT	eus
V;ARGABS3;ARGABSSG;ARGIO1;ARGIOPL;IMP	eus
V;ARGABS3;ARGABSSG;ARGIO1;ARGIOPL;INFM;FEM;PAST;IND	eus
V;ARGABS3;ARGABSSG;ARGIO1;ARGIOPL;INFM;FEM;PAST;POT	eus
V;ARGABS3;ARGABSSG;ARGIO1;ARGIOPL;INFM;FEM;PRES;IND	eus
V;ARGABS3;ARGABSSG;ARGIO1;ARGIOPL;INFM;MASC;PAST;IND	eus
V;ARGABS3;ARGABSSG;ARGIO1;ARGIOPL;INFM;MASC;PAST;POT	eus
V;ARGABS3;ARGABSSG;ARGIO1;ARGIOPL;INFM;MASC;PRES;IND	eus
V;ARGABS3;ARGABSSG;ARGIO1;ARGIOPL;INFM;MASC;PRES;POT	eus
V;ARGABS3;ARGABSSG;ARGIO1;ARGIOPL;PAST;IND	eus
V;ARGABS3;ARGABSSG;ARGIO1;ARGIOPL;PAST;POT	eus
V;ARGABS3;ARGABSSG;ARGIO1;ARGIOPL;PRES;IND	eus
V;ARGABS3;ARGABSSG;ARGIO1;ARGIOPL;PRES;POT	eus
V;ARGABS3;ARGABSSG;ARGIO1;ARGIOSG;HYP;IND	eus
V;ARGABS3;ARGABSSG;ARGIO1;ARGIOSG;HYP;POT	eus
V;ARGABS3;ARGABSSG;ARGIO1;ARGIOSG;IMP	eus
V;ARGABS3;ARGABSSG;ARGIO1;ARGIOSG;INFM;FEM;PAST;IND	eus
V;ARGABS3;ARGABSSG;ARGIO1;ARGIOSG;INFM;FEM;PAST;POT	eus
V;ARGABS3;ARGABSSG;ARGIO1;ARGIOSG;INFM;FEM;PRES;IND	eus
V;ARGABS3;ARGABSSG;ARGIO1;ARGIOSG;INFM;FEM;PRES;POT	eus
V;ARGABS3;ARGABSSG;ARGIO1;ARGIOSG;INFM;MASC;PAST;IND	eus
V;ARGABS3;ARGABSSG;ARGIO1;ARGIOSG;INFM;MASC;PAST;POT	eus
V;ARGABS3;ARGABSSG;ARGIO1;ARGIOSG;INFM;MASC;PRES;IND	eus
V;ARGABS3;ARGABSSG;ARGIO1;ARGIOSG;INFM;MASC;PRES;POT	eus
V;ARGABS3;ARGABSSG;ARGIO1;ARGIOSG;PAST;IND	eus
V;ARGABS3;ARGABSSG;ARGIO1;ARGIOSG;PAST;POT	eus
V;ARGABS3;ARGABSSG;ARGIO1;ARGIOSG;PRES;IND	eus
V;ARGABS3;ARGABSSG;ARGIO1;ARGIOSG;PRES;POT	eus
V;ARGABS3;ARGABSSG;ARGIO2;ARGIOPL;HYP;IND	eus
V;ARGABS3;ARGABSSG;ARGIO2;ARGIOPL;HYP;POT	eus
V;ARGABS3;ARGABSSG;ARGIO2;ARGIOPL;IMP	eus
V;ARGABS3;ARGABSSG;ARGIO2;ARGIOPL;PAST;IND	eus
V;ARGABS3;ARGABSSG;ARGIO2;ARGIOPL;PAST;POT	eus
V;ARGABS3;ARGABSSG;ARGIO2;ARGIOPL;PRES;IND	eus
V;ARGABS3;ARGABSSG;ARGIO2;ARGIOPL;PRES;POT	eus
V;ARGABS3;ARGABSSG;ARGIO2;ARGIOSG;ARGIOINFM;ARGIOFEM;HYP;IND	eus
V;ARGABS3;ARGABSSG;ARGIO2;ARGIOSG;ARGIOINFM;ARGIOFEM;HYP;POT	eus
V;ARGABS3;ARGABSSG;ARGIO2;ARGIOSG;ARGIOINFM;ARGIOFEM;IMP	eus
V;ARGABS3;ARGABSSG;ARGIO2;ARGIOSG;ARGIOINFM;ARGIOFEM;PAST;IND	eus
V;ARGABS3;ARGABSSG;ARGIO2;ARGIOSG;ARGIOINFM;ARGIOFEM;PAST;POT	eus
V;ARGABS3;ARGABSSG;ARGIO2;ARGIOSG;ARGIOINFM;ARGIOFEM;PRES;IND	eus
V;ARGABS3;ARGABSSG;ARGIO2;ARGIOSG;ARGIOINFM;ARGIOFEM;PRES;POT	eus
V;ARGABS3;ARGABSSG;ARGIO2;ARGIOSG;ARGIOINFM;ARGIOMASC;HYP;IND	eus
V;ARGABS3;ARGABSSG;ARGIO2;ARGIOSG;ARGIOINFM;ARGIOMASC;HYP;POT	eus
V;ARGABS3;ARGABSSG;ARGIO2;ARGIOSG;ARGIOINFM;ARGIOMASC;IMP	eus
V;ARGABS3;ARGABSSG;ARGIO2;ARGIOSG;ARGIOINFM;ARGIOMASC;PAST;IND	eus
V;ARGABS3;ARGABSSG;ARGIO2;ARGIOSG;ARGIOINFM;ARGIOMASC;PAST;POT	eus
V;ARGABS3;ARGABSSG;ARGIO2;ARGIOSG;ARGIOINFM;ARGIOMASC;PRES;IND	eus
V;ARGABS3;ARGABSSG;ARGIO2;ARGIOSG;ARGIOINFM;ARGIOMASC;PRES;POT	eus
V;ARGABS3;ARGABSSG;ARGIO2;ARGIOSG;HYP;IND	eus
V;ARGABS3;ARGABSSG;ARGIO2;ARGIOSG;HYP;POT	eus
V;ARGABS3;ARGABSSG;ARGIO2;ARGIOSG;IMP	eus
V;ARGABS3;ARGABSSG;ARGIO2;ARGIOSG;PAST;IND	eus
V;ARGABS3;ARGABSSG;ARGIO2;ARGIOSG;PAST;POT	eus
V;ARGABS3;ARGABSSG;ARGIO2;ARGIOSG;PRES;IND	eus
V;ARGABS3;ARGABSSG;ARGIO2;ARGIOSG;PRES;POT	eus
V;ARGABS3;ARGABSSG;ARGIO3;ARGIOPL;HYP;IND	eus
V;ARGABS3;ARGABSSG;ARGIO3;ARGIOPL;HYP;POT	eus
V;ARGABS3;ARGABSSG;ARGIO3;ARGIOPL;IMP	eus
V;ARGABS3;ARGABSSG;ARGIO3;ARGIOPL;INFM;FEM;PAST;IND	eus
V;ARGABS3;ARGABSSG;ARGIO3;ARGIOPL;INFM;FEM;PAST;POT	eus
V;ARGABS3;ARGABSSG;ARGIO3;ARGIOPL;INFM;FEM;PRES;IND	eus
V;ARGABS3;ARGABSSG;ARGIO3;ARGIOPL;INFM;MASC;PAST;IND	eus
V;ARGABS3;ARGABSSG;ARGIO3;ARGIOPL;INFM;MASC;PAST;POT	eus
V;ARGABS3;ARGABSSG;ARGIO3;ARGIOPL;INFM;MASC;PRES;IND	eus
V;ARGABS3;ARGABSSG;ARGIO3;ARGIOPL;INFM;MASC;PRES;POT	eus
V;ARGABS3;ARGABSSG;ARGIO3;ARGIOPL;PAST;IND	eus
V;ARGABS3;ARGABSSG;ARGIO3;ARGIOPL;PAST;POT	eus
V;ARGABS3;ARGABSSG;ARGIO3;ARGIOPL;PRES;IND	eus
V;ARGABS3;ARGABSSG;ARGIO3;ARGIOPL;PRES;POT	eus
V;ARGABS3;ARGABSSG;ARGIO3;ARGIOSG;HYP;IND	eus
V;ARGABS3;ARGABSSG;ARGIO3;ARGIOSG;HYP;POT	eus
V;ARGABS3;ARGABSSG;ARGIO3;ARGIOSG;IMP	eus
V;ARGABS3;ARGABSSG;ARGIO3;ARGIOSG;INFM;FEM;PAST;IND	eus
V;ARGABS3;ARGABSSG;ARGIO3;ARGIOSG;INFM;FEM;PAST;POT	eus
V;ARGABS3;ARGABSSG;ARGIO3;ARGIOSG;INFM;FEM;PRES;IND	eus
V;ARGABS3;ARGABSSG;ARGIO3;ARGIOSG;INFM;MASC;PAST;IND	eus
V;ARGABS3;ARGABSSG;ARGIO3;ARGIOSG;INFM;MASC;PAST;POT	eus
V;ARGABS3;ARGABSSG;ARGIO3;ARGIOSG;INFM;MASC;PRES;IND	eus
V;ARGABS3;ARGABSSG;ARGIO3;ARGIOSG;INFM;MASC;PRES;POT	eus
V;ARGABS3;ARGABSSG;ARGIO3;ARGIOSG;PAST;IND	eus
V;ARGABS3;ARGABSSG;ARGIO3;ARGIOSG;PAST;POT	eus
V;ARGABS3;ARGABSSG;ARGIO3;ARGIOSG;PRES;IND	eus
V;ARGABS3;ARGABSSG;ARGIO3;ARGIOSG;PRES;POT	eus
V;ARGABS3;ARGABSSG;HYP;IND	eus
V;ARGABS3;ARGABSSG;HYP;POT	eus
V;ARGABS3;ARGABSSG;IMP	eus
V;ARGABS3;ARGABSSG;INFM;FEM;PAST;IND	eus
V;ARGABS3;ARGABSSG;INFM;FEM;PAST;POT	eus
V;ARGABS3;ARGABSSG;INFM;FEM;PRES;IND	eus
V;ARGABS3;ARGABSSG;INFM;FEM;PRES;POT	eus
V;ARGABS3;ARGABSSG;INFM;MASC;PAST;IND	eus
V;ARGABS3;ARGABSSG;INFM;MASC;PAST;POT	eus
V;ARGABS3;ARGABSSG;INFM;MASC;PRES;IND	eus
V;ARGABS3;ARGABSSG;INFM;MASC;PRES;POT	eus
V;ARGABS3;ARGABSSG;PAST;IND	eus
V;ARGABS3;ARGABSSG;PAST;POT	eus
V;ARGABS3;ARGABSSG;PRES;IND	eus
V;ARGABS3;ARGABSSG;PRES;POT	eus
V;AUTO;COND	gle
V;AUTO;FUT;IND	gle
V;AUTO;IMP	gle
V;AUTO;PRS;IND	gle
V;AUTO;PST;HAB;IND	gle
V;AUTO;PST;IND	gle
V;AUTO;SBJV;PRS	gle
V;AUTO;SBJV;PST	gle
V;COL;1;PL;IND;IPFV	cym
V;COL;1;PL;IND;PRS	cym
V;COL;1;PL;IND;PST	cym
V;COL;1;SG;IND;IPFV	cym
V;COL;1;SG;IND;PRS	cym
V;COL;1;SG;IND;PST	cym
V;COL;2;PL;IMP	cym
V;COL;2;PL;IND;IPFV	cym
V;COL;2;PL;IND;PRS	cym
V;COL;2;PL;IND;PST	cym
V;COL;2;SG;IMP	cym
V;COL;2;SG;IND;IPFV	cym
V;COL;2;SG;IND;PRS	cym
V;COL;2;SG;IND;PST	cym
V;COL;3;PL;IND;IPFV	cym
V;COL;3;PL;IND;PRS	cym
V;COL;3;PL;IND;PST	cym
V;COL;3;SG;IND;IPFV	cym
V;COL;3;SG;IND;PRS	cym
V;COL;3;SG;IND;PST	cym
V;COND;1;DU	sme
V;COND;1;DU;LGSPEC	sme
V;COND;1;PL	cat, fra, ita, pol, sme, spa
V;COND;1;PL;LGSPEC	sme
V;COND;1;PL;MASC;HUM	pol
V;COND;1;SG	cat, fra, ita, sme, spa
V;COND;1;SG;FEM	pol
V;COND;1;SG;LGSPEC	sme
V;COND;1;SG;MASC	pol
V;COND;2;DU	sme
V;COND;2;DU;LGSPEC	sme
V;COND;2;PL	cat, fra, ita, pol, sme, spa
V;COND;2;PL;LGSPEC	sme
V;COND;2;PL;MASC;HUM	pol
V;COND;2;SG	cat, fra, ita, sme, spa
V;COND;2;SG;FEM	pol
V;COND;2;SG;LGSPEC	sme
V;COND;2;SG;MASC	pol
V;COND;3;DU	sme
V;COND;3;DU;LGSPEC	sme
V;COND;3;PL	cat, fra, ita, pol, sme, spa
V;COND;3;PL;LGSPEC	sme
V;COND;3;PL;MASC;HUM	pol
V;COND;3;SG	cat, fra, ita, sme, spa
V;COND;3;SG;FEM	pol
V;COND;3;SG;LGSPEC	sme
V;COND;3;SG;MASC	pol
V;COND;3;SG;NEUT	pol
V;COND;ACT	gla
V;COND;PASS	gla
V;COND;PRS	lav, slv
V;COND;PRS;1;PL;FEM	ces
V;COND;PRS;1;PL;MASC	ces
V;COND;PRS;1;PL;MASC;ANIM	ces
V;COND;PRS;1;PL;MASC;INAN	ces
V;COND;PRS;1;PL;NEUT	ces
V;COND;PRS;1;SG;FEM	ces
V;COND;PRS;1;SG;MASC	ces
V;COND;PRS;1;SG;NEUT	ces
V;COND;PRS;2;PL;FEM	ces
V;COND;PRS;2;PL;MASC	ces
V;COND;PRS;2;PL;NEUT	ces
V;COND;PRS;2;SG;FEM	ces
V;COND;PRS;2;SG;FORM;FEM	ces
V;COND;PRS;2;SG;FORM;MASC	ces
V;COND;PRS;2;SG;FORM;NEUT	ces
V;COND;PRS;2;SG;MASC	ces
V;COND;PRS;2;SG;NEUT	ces
V;COND;PRS;3;PL;FEM	ces
V;COND;PRS;3;PL;NEUT	ces
V;COND;PRS;3;SG;FEM	ces
V;COND;PRS;3;SG;MASC	ces
V;COND;PRS;3;SG;NEUT	ces
V;COND;PRS;DEF;1;PL	hun
V;COND;PRS;DEF;1;SG	hun
V;COND;PRS;DEF;2;PL	hun
V;COND;PRS;DEF;2;SG	hun
V;COND;PRS;DEF;3;PL	hun
V;COND;PRS;DEF;3;SG	hun
V;COND;PRS;INDF;1;PL	hun
V;COND;PRS;INDF;1;SG	hun
V;COND;PRS;INDF;2;PL	hun
V;COND;PRS;INDF;2;SG	hun
V;COND;PRS;INDF;3;PL	hun
V;COND;PRS;INDF;3;SG	hun
V;COND;PST	lav, slv
V;COND;PST;1;PL;FEM	ces
V;COND;PST;1;PL;MASC	ces
V;COND;PST;1;PL;NEUT	ces
V;COND;PST;1;SG;FEM	ces
V;COND;PST;1;SG;MASC	ces
V;COND;PST;1;SG;NEUT	ces
V;COND;PST;2;PL;FEM	ces
V;COND;PST;2;PL;MASC	ces
V;COND;PST;2;PL;NEUT	ces
V;COND;PST;2;SG;FEM	ces
V;COND;PST;2;SG;FORM;FEM	ces
V;COND;PST;2;SG;FORM;MASC	ces
V;COND;PST;2;SG;FORM;NEUT	ces
V;COND;PST;2;SG;MASC	ces
V;COND;PST;2;SG;NEUT	ces
V;COND;PST;3;PL;FEM	ces
V;COND;PST;3;PL;MASC;ANIM	ces
V;COND;PST;3;PL;MASC;INAN	ces
V;COND;PST;3;PL;NEUT	ces
V;COND;PST;3;SG;FEM	ces
V;COND;PST;3;SG;MASC	ces
V;COND;PST;3;SG;NEUT	ces
V;DRCT;PST	hai
V;DRCT;PST;HAB	hai
V;DUR	hai
V;FUT;1;PL	pol
V;FUT;1;PL;MASC;HUM	pol
V;FUT;1;SG	pol, que
V;FUT;1;SG;FEM	pol
V;FUT;1;SG;MASC	pol
V;FUT;1+EXCL;PL	que
V;FUT;1+INCL;PL	que
V;FUT;2;PL	pol, que
V;FUT;2;PL;MASC;HUM	pol
V;FUT;2;SG	pol, que
V;FUT;2;SG;FEM	pol
V;FUT;2;SG;MASC	pol
V;FUT;3;PL	pol, que
V;FUT;3;PL;MASC;HUM	pol
V;FUT;3;SG	pol, que
V;FUT;3;SG;FEM	pol
V;FUT;3;SG;MASC	pol
V;FUT;3;SG;NEUT	pol
V;FUT;ACT	gla
V;FUT;LGSPEC6	hai
V;FUT;PASS	gla
V;FUT;REFL;INT	hai
V;IMMED;FUT	hai
V;IMMED;PRS	hai
V;IMP	nno, nob, swe
V;IMP;1;DU	slv, sme
V;IMP;1;PL	ces, pol, slv, sme
V;IMP;1;SG	pol, sme
V;IMP;2;DU	dsb, slv, sme
V;IMP;2;PL	ces, deu, dsb, fao, isl, pol, slv, sme
V;IMP;2;SG	ces, deu, dsb, fao, isl, pol, slv, sme
V;IMP;2;SG;FORM	ces
V;IMP;3;DU	sme
V;IMP;3;PL	pol, sme
V;IMP;3;SG	pol, sme
V;IMP;FUT;3;PL	lat
V;IMP;FUT;3;SG	lat
V;IMP;NEG;2;DU;ARG1;ARGEXCL;ARGDU;TR	klr
V;IMP;NEG;2;DU;ARG1;ARGEXCL;ARGPL;TR	klr
V;IMP;NEG;2;DU;ARG1;ARGSG;TR	klr
V;IMP;NEG;2;DU;ARG3;ARGDU;TR	klr
V;IMP;NEG;2;DU;ARG3;ARGPL;TR	klr
V;IMP;NEG;2;DU;ARG3;ARGSG;TR	klr
V;IMP;NEG;2;DU;INTR	klr
V;IMP;NEG;2;DU;REFL	klr
V;IMP;NEG;2;PL	que
V;IMP;NEG;2;PL;ARG1;ARGEXCL;ARGDU;TR	klr
V;IMP;NEG;2;PL;ARG1;ARGEXCL;ARGPL;TR	klr
V;IMP;NEG;2;PL;ARG1;ARGSG;TR	klr
V;IMP;NEG;2;PL;ARG3;ARGDU;TR	klr
V;IMP;NEG;2;PL;ARG3;ARGPL;TR	klr
V;IMP;NEG;2;PL;ARG3;ARGSG;TR	klr
V;IMP;NEG;2;PL;INTR	klr
V;IMP;NEG;2;PL;REFL	klr
V;IMP;NEG;2;SG	que
V;IMP;NEG;2;SG;ARG1;ARGEXCL;ARGDU;TR	klr
V;IMP;NEG;2;SG;ARG1;ARGEXCL;ARGPL;TR	klr
V;IMP;NEG;2;SG;ARG1;ARGSG;TR	klr
V;IMP;NEG;2;SG;ARG3;ARGDU;TR	klr
V;IMP;NEG;2;SG;ARG3;ARGPL;TR	klr
V;IMP;NEG;2;SG;ARG3;ARGSG;TR	klr
V;IMP;NEG;2;SG;INTR	klr
V;IMP;NEG;2;SG;REFL	klr
V;IMP;NEG;3;PL	que
V;IMP;NEG;3;SG	que
V;IMP;PASS;FUT;3;PL	lat
V;IMP;PASS;FUT;3;SG	lat
V;IMP;PASS;PRS;3;PL	lat
V;IMP;PASS;PRS;3;SG	lat
V;IMP;PL	nld
V;IMP;POS;2;DU;ARG1;ARGEXCL;ARGDU;TR	klr
V;IMP;POS;2;DU;ARG1;ARGEXCL;ARGPL;TR	klr
V;IMP;POS;2;DU;ARG1;ARGSG;TR	klr
V;IMP;POS;2;DU;ARG3;ARGDU;TR	klr
V;IMP;POS;2;DU;ARG3;ARGPL;TR	klr
V;IMP;POS;2;DU;ARG3;ARGSG;TR	klr
V;IMP;POS;2;DU;INTR	klr
V;IMP;POS;2;DU;REFL	klr
V;IMP;POS;2;PL	que
V;IMP;POS;2;PL;ARG1;ARGEXCL;ARGDU;TR	klr
V;IMP;POS;2;PL;ARG1;ARGEXCL;ARGPL;TR	klr
V;IMP;POS;2;PL;ARG1;ARGSG;TR	klr
V;IMP;POS;2;PL;ARG3;ARGDU;TR	klr
V;IMP;POS;2;PL;ARG3;ARGPL;TR	klr
V;IMP;POS;2;PL;ARG3;ARGSG;TR	klr
V;IMP;POS;2;PL;INTR	klr
V;IMP;POS;2;PL;REFL	klr
V;IMP;POS;2;SG	que
V;IMP;POS;2;SG;ARG1;ARGEXCL;ARGDU;TR	klr
V;IMP;POS;2;SG;ARG1;ARGEXCL;ARGPL;TR	klr
V;IMP;POS;2;SG;ARG1;ARGSG;TR	klr
V;IMP;POS;2;SG;ARG3;ARGDU;TR	klr
V;IMP;POS;2;SG;ARG3;ARGPL;TR	klr
V;IMP;POS;2;SG;ARG3;ARGSG;TR	klr
V;IMP;POS;2;SG;INTR	klr
V;IMP;POS;2;SG;REFL	klr
V;IMP;POS;3;PL	que
V;IMP;POS;3;SG	que
V;IMP;PRS;3;PL	lat
V;IMP;PRS;3;SG	lat
V;IMP;SG	nld
V;IND:PASS;PST;2;PL;IPFV	lat
V;IND;1;PL;FUT;NEG;DECL	tur
V;IND;1;PL;FUT;NEG;INTR	tur
V;IND;1;PL;FUT;POS;DECL	tur
V;IND;1;PL;FUT;POS;INTR	tur
V;IND;1;PL;PRS;NEG;DECL	tur
V;IND;1;PL;PRS;NEG;INTR	tur
V;IND;1;PL;PRS;POS;DECL	tur
V;IND;1;PL;PRS;POS;INTR	tur
V;IND;1;PL;PRS;PROG;NEG;DECL	tur
V;IND;1;PL;PRS;PROG;NEG;INTR	tur
V;IND;1;PL;PRS;PROG;POS;DECL	tur
V;IND;1;PL;PRS;PROG;POS;INTR	tur
V;IND;1;PL;PST;NEG;DECL	tur
V;IND;1;PL;PST;NEG;INTR	tur
V;IND;1;PL;PST;POS;DECL	tur
V;IND;1;PL;PST;POS;INTR	tur
V;IND;1;PL;PST;PROG;NEG;DECL	tur
V;IND;1;PL;PST;PROG;NEG;INTR	tur
V;IND;1;PL;PST;PROG;POS;DECL	tur
V;IND;1;PL;PST;PROG;POS;INTR	tur
V;IND;1;SG;FUT;NEG;DECL	tur
V;IND;1;SG;FUT;NEG;INTR	tur
V;IND;1;SG;FUT;POS;DECL	tur
V;IND;1;SG;FUT;POS;INTR	tur
V;IND;1;SG;PRS;NEG;DECL	tur
V;IND;1;SG;PRS;NEG;INTR	tur
V;IND;1;SG;PRS;POS;DECL	tur
V;IND;1;SG;PRS;POS;INTR	tur
V;IND;1;SG;PRS;PROG;NEG;DECL	tur
V;IND;1;SG;PRS;PROG;NEG;INTR	tur
V;IND;1;SG;PRS;PROG;POS;DECL	tur
V;IND;1;SG;PRS;PROG;POS;INTR	tur
V;IND;1;SG;PST;NEG;DECL	tur
V;IND;1;SG;PST;NEG;INTR	tur
V;IND;1;SG;PST;POS;DECL	tur
V;IND;1;SG;PST;POS;INTR	tur
V;IND;1;SG;PST;PROG;NEG;DECL	tur
V;IND;1;SG;PST;PROG;NEG;INTR	tur
V;IND;1;SG;PST;PROG;POS;DECL	tur
V;IND;1;SG;PST;PROG;POS;INTR	tur
V;IND;2;PL;FUT;NEG;DECL	tur
V;IND;2;PL;FUT;NEG;INTR	tur
V;IND;2;PL;FUT;POS;DECL	tur
V;IND;2;PL;FUT;POS;INTR	tur
V;IND;2;PL;PRS;NEG;DECL	tur
V;IND;2;PL;PRS;NEG;INTR	tur
V;IND;2;PL;PRS;POS;DECL	tur
V;IND;2;PL;PRS;POS;INTR	tur
V;IND;2;PL;PRS;PROG;NEG;DECL	tur
V;IND;2;PL;PRS;PROG;NEG;INTR	tur
V;IND;2;PL;PRS;PROG;POS;DECL	tur
V;IND;2;PL;PRS;PROG;POS;INTR	tur
V;IND;2;PL;PST;NEG;DECL	tur
V;IND;2;PL;PST;NEG;INTR	tur
V;IND;2;PL;PST;POS;DECL	tur
V;IND;2;PL;PST;POS;INTR	tur
V;IND;2;PL;PST;PROG;NEG;DECL	tur
V;IND;2;PL;PST;PROG;NEG;INTR	tur
V;IND;2;PL;PST;PROG;POS;DECL	tur
V;IND;2;PL;PST;PROG;POS;INTR	tur
V;IND;2;SG;FUT;NEG;DECL	tur
V;IND;2;SG;FUT;NEG;INTR	tur
V;IND;2;SG;FUT;POS;DECL	tur
V;IND;2;SG;FUT;POS;INTR	tur
V;IND;2;SG;PRS;NEG;DECL	tur
V;IND;2;SG;PRS;NEG;INTR	tur
V;IND;2;SG;PRS;POS;DECL	tur
V;IND;2;SG;PRS;POS;INTR	tur
V;IND;2;SG;PRS;PROG;NEG;DECL	tur
V;IND;2;SG;PRS;PROG;NEG;INTR	tur
V;IND;2;SG;PRS;PROG;POS;DECL	tur
V;IND;2;SG;PRS;PROG;POS;INTR	tur
V;IND;2;SG;PST;NEG;DECL	tur
V;IND;2;SG;PST;NEG;INTR	tur
V;IND;2;SG;PST;POS;DECL	tur
V;IND;2;SG;PST;POS;INTR	tur
V;IND;2;SG;PST;PROG;NEG;DECL	tur
V;IND;2;SG;PST;PROG;NEG;INTR	tur
V;IND;2;SG;PST;PROG;POS;DECL	tur
V;IND;2;SG;PST;PROG;POS;INTR	tur
V;IND;3;PL;FUT;NEG;DECL	tur
V;IND;3;PL;FUT;NEG;INTR	tur
V;IND;3;PL;FUT;POS;DECL	tur
V;IND;3;PL;FUT;POS;INTR	tur
V;IND;3;PL;PRS;NEG;DECL	tur
V;IND;3;PL;PRS;NEG;INTR	tur
V;IND;3;PL;PRS;POS;DECL	tur
V;IND;3;PL;PRS;POS;INTR	tur
V;IND;3;PL;PRS;PROG;NEG;DECL	tur
V;IND;3;PL;PRS;PROG;NEG;INTR	tur
V;IND;3;PL;PRS;PROG;POS;DECL	tur
V;IND;3;PL;PRS;PROG;POS;INTR	tur
V;IND;3;PL;PST;NEG;DECL	tur
V;IND;3;PL;PST;NEG;INTR	tur
V;IND;3;PL;PST;POS;DECL	tur
V;IND;3;PL;PST;POS;INTR	tur
V;IND;3;PL;PST;PROG;NEG;DECL	tur
V;IND;3;PL;PST;PROG;NEG;INTR	tur
V;IND;3;PL;PST;PROG;POS;DECL	tur
V;IND;3;PL;PST;PROG;POS;INTR	tur
V;IND;3;SG;FUT;NEG;DECL	tur
V;IND;3;SG;FUT;NEG;INTR	tur
V;IND;3;SG;FUT;POS;DECL	tur
V;IND;3;SG;FUT;POS;INTR	tur
V;IND;3;SG;PRS;NEG;DECL	tur
V;IND;3;SG;PRS;NEG;INTR	tur
V;IND;3;SG;PRS;POS;DECL	tur
V;IND;3;SG;PRS;POS;INTR	tur
V;IND;3;SG;PRS;PROG;NEG;DECL	tur
V;IND;3;SG;PRS;PROG;NEG;INTR	tur
V;IND;3;SG;PRS;PROG;POS;DECL	tur
V;IND;3;SG;PRS;PROG;POS;INTR	tur
V;IND;3;SG;PST;NEG;DECL	tur
V;IND;3;SG;PST;NEG;INTR	tur
V;IND;3;SG;PST;POS;DECL	tur
V;IND;3;SG;PST;POS;INTR	tur
V;IND;3;SG;PST;PROG;NEG;DECL	tur
V;IND;3;SG;PST;PROG;NEG;INTR	tur
V;IND;3;SG;PST;PROG;POS;DECL	tur
V;IND;3;SG;PST;PROG;POS;INTR	tur
V;IND;FUT	slv
V;IND;FUT;1;PL	cat, ces, fra, ita, lat, spa
V;IND;FUT;1;PL;PRF	lat
V;IND;FUT;1;SG	cat, ces, fra, ita, lat, spa
V;IND;FUT;1;SG;PRF	lat
V;IND;FUT;2;PL	cat, ces, fra, ita, lat, spa
V;IND;FUT;2;PL;PRF	lat
V;IND;FUT;2;SG	cat, ces, fra, ita, lat, spa
V;IND;FUT;2;SG;FORM	ces
V;IND;FUT;2;SG;PRF	lat
V;IND;FUT;3;PL	cat, ces, fra, ita, lat, spa
V;IND;FUT;3;PL;PRF	lat
V;IND;FUT;3;SG	cat, ces, fra, ita, lat, spa
V;IND;FUT;3;SG;PRF	lat
V;IND;PASS;FUT;1;PL	lat
V;IND;PASS;FUT;1;SG	lat
V;IND;PASS;FUT;2;PL	lat
V;IND;PASS;FUT;2;SG	lat
V;IND;PASS;FUT;3;PL	lat
V;IND;PASS;FUT;3;SG	lat
V;IND;PASS;PRS;1;PL	lat
V;IND;PASS;PRS;1;SG	lat
V;IND;PASS;PRS;2;PL	lat
V;IND;PASS;PRS;2;SG	lat
V;IND;PASS;PRS;3;PL	lat
V;IND;PASS;PRS;3;SG	lat
V;IND;PASS;PST;1;PL;IPFV	lat
V;IND;PASS;PST;1;SG;IPFV	lat
V;IND;PASS;PST;2;SG;IPFV	lat
V;IND;PASS;PST;3;PL;IPFV	lat
V;IND;PASS;PST;3;SG;IPFV	lat
V;IND;PRF;PST	slv
V;IND;PRS;1;DU	slv
V;IND;PRS;1;PL	cat, ces, deu, fra, isl, ita, lat, ron, slv, spa
V;IND;PRS;1;SG	cat, ces, deu, fao, fra, isl, ita, lat, nld, ron, slv, spa
V;IND;PRS;2;DU	slv
V;IND;PRS;2;PL	cat, ces, deu, fra, isl, ita, lat, ron, slv, spa
V;IND;PRS;2;SG	cat, ces, deu, fao, fra, isl, ita, lat, nld, ron, slv, spa
V;IND;PRS;2;SG;FORM	ces
V;IND;PRS;3	fao
V;IND;PRS;3;DU	slv
V;IND;PRS;3;PL	cat, ces, deu, fra, isl, ita, lat, ron, slv, spa
V;IND;PRS;3;SG	cat, ces, deu, fao, fra, isl, ita, lat, nld, ron, slv, spa
V;IND;PRS;DEF;1;PL	hun
V;IND;PRS;DEF;1;SG	hun
V;IND;PRS;DEF;2;PL	hun
V;IND;PRS;DEF;2;SG	hun
V;IND;PRS;DEF;3;PL	hun
V;IND;PRS;DEF;3;SG	hun
V;IND;PRS;INDF;1;PL	hun
V;IND;PRS;INDF;1;SG	hun
V;IND;PRS;INDF;2;PL	hun
V;IND;PRS;INDF;2;SG	hun
V;IND;PRS;INDF;3;PL	hun
V;IND;PRS;INDF;3;SG	hun
V;IND;PRS;PL	nld
V;IND;PST	slv
V;IND;PST;1;PL	deu
V;IND;PST;1;PL:IPFV	cat
V;IND;PST;1;PL:PFV	cat
V;IND;PST;1;PL;FEM	ces
V;IND;PST;1;PL;IPFV	fra, ita, lat, ron, spa
V;IND;PST;1;PL;MASC	ces
V;IND;PST;1;PL;NEUT	ces
V;IND;PST;1;PL;PFV	fra, ita, lat, ron, spa
V;IND;PST;1;PL;PRF	lat, ron
V;IND;PST;1;SG	deu, fao, isl, nld
V;IND;PST;1;SG;FEM	ces
V;IND;PST;1;SG;IPFV	cat, fra, ita, lat, ron, spa
V;IND;PST;1;SG;MASC	ces
V;IND;PST;1;SG;NEUT	ces
V;IND;PST;1;SG;PFV	cat, fra, ita, lat, ron, spa
V;IND;PST;1;SG;PRF	lat, ron
V;IND;PST;2;PL	deu, isl
V;IND;PST;2;PL;FEM	ces
V;IND;PST;2;PL;IPFV	cat, fra, ita, lat, ron, spa
V;IND;PST;2;PL;MASC	ces
V;IND;PST;2;PL;NEUT	ces
V;IND;PST;2;PL;PFV	cat, fra, ita, lat, ron, spa
V;IND;PST;2;PL;PRF	lat, ron
V;IND;PST;2;SG	ces, deu, fao, isl, nld
V;IND;PST;2;SG;FEM	ces
V;IND;PST;2;SG;FORM;FEM	ces
V;IND;PST;2;SG;FORM;MASC	ces
V;IND;PST;2;SG;FORM;NEUT	ces
V;IND;PST;2;SG;IPFV	cat, fra, ita, lat, ron, spa
V;IND;PST;2;SG;MASC	ces
V;IND;PST;2;SG;NEUT	ces
V;IND;PST;2;SG;PFV	cat, fra, ita, lat, ron, spa
V;IND;PST;2;SG;PRF	lat, ron
V;IND;PST;3	fao
V;IND;PST;3;PL	deu, isl
V;IND;PST;3;PL;FEM	ces
V;IND;PST;3;PL;IPFV	cat, fra, ita, lat, ron, spa
V;IND;PST;3;PL;MASC	ces
V;IND;PST;3;PL;MASC;ANIM	ces
V;IND;PST;3;PL;MASC;INAN	ces
V;IND;PST;3;PL;NEUT	ces
V;IND;PST;3;PL;PFV	cat, fra, ita, lat, ron, spa
V;IND;PST;3;PL;PRF	lat, ron
V;IND;PST;3;SG	deu, fao, isl, nld
V;IND;PST;3;SG;FEM	ces
V;IND;PST;3;SG;IPFV	cat, fra, ita, lat, ron, spa
V;IND;PST;3;SG;MASC	ces
V;IND;PST;3;SG;NEUT	ces
V;IND;PST;3;SG;PFV	cat, fra, ita, lat, ron, spa
V;IND;PST;3;SG;PRF	lat, ron
V;IND;PST;DEF;1;PL	hun
V;IND;PST;DEF;1;SG	hun
V;IND;PST;DEF;2;PL	hun
V;IND;PST;DEF;2;SG	hun
V;IND;PST;DEF;3;PL	hun
V;IND;PST;DEF;3;SG	hun
V;IND;PST;INDF;1;PL	hun
V;IND;PST;INDF;1;SG	hun
V;IND;PST;INDF;2;PL	hun
V;IND;PST;INDF;2;SG	hun
V;IND;PST;INDF;3;PL	hun
V;IND;PST;INDF;3;SG	hun
V;IND;PST;PL	nld
V;INT;FUT;LGSPEC8	hai
V;INT;FUT;REMT	hai
V;INT;LGSPEC8;PRS	hai
V;INT;MED;FUT	hai
V;INT;PROX;FUT	hai
V;INT;PRS;HAB	hai
V;INT;PST	hai
V;INT;PST;HAB	hai
V;IRR;PRS	hai
V;LGSPEC1;FUT	lav
V;LGSPEC1;IMMED;PRS	hai
V;LGSPEC1;IMP	lav
V;LGSPEC1;INT;FUT	hai
V;LGSPEC1;INT;PRS	hai
V;LGSPEC1;INT;PST	hai
V;LGSPEC1;INT;PST;HAB	hai
V;LGSPEC1;LGSPEC8;PRS	hai
V;LGSPEC1;PRS	lav
V;LGSPEC1;PST	lav
V;LGSPEC2;FUT	hai
V;LGSPEC2;IND	lav
V;LGSPEC2;LGSPEC7	lav
V;LGSPEC2;LgSPEC8	lav
V;LGSPEC2;PRS	hai
V;LGSPEC2;PST	hai
V;LGSPEC2;PST;HAB	hai
V;LGSPEC2;REL	hai
V;LGSPEC4;PST	hai
V;LGSPEC4;PST;HAB	hai
V;LGSPEC5;PST	hai
V;LGSPEC6	hai
V;LGSPEC7	hai
V;LGSPEC8;FUT	hai
V;LGSPEC8;PRS	hai
V;LGSPEC9;MED;FUT	hai
V;LIT;1;PL;IMP	cym
V;LIT;1;PL;IND;IPFV	cym
V;LIT;1;PL;IND;PRS	cym
V;LIT;1;PL;IND;PST	cym
V;LIT;1;PL;IND;PST;PFV	cym
V;LIT;1;PL;SBJV	cym
V;LIT;1;SG;IND;IPFV	cym
V;LIT;1;SG;IND;PRS	cym
V;LIT;1;SG;IND;PST	cym
V;LIT;1;SG;IND;PST;PFV	cym
V;LIT;1;SG;SBJV	cym
V;LIT;2;PL;IMP	cym
V;LIT;2;PL;IND;IPFV	cym
V;LIT;2;PL;IND;PRS	cym
V;LIT;2;PL;IND;PST	cym
V;LIT;2;PL;IND;PST;PFV	cym
V;LIT;2;PL;SBJV	cym
V;LIT;2;SG;IMP	cym
V;LIT;2;SG;IND;IPFV	cym
V;LIT;2;SG;IND;PRS	cym
V;LIT;2;SG;IND;PST	cym
V;LIT;2;SG;IND;PST;PFV	cym
V;LIT;2;SG;SBJV	cym
V;LIT;3;PL;IMP	cym
V;LIT;3;PL;IND;IPFV	cym
V;LIT;3;PL;IND;PRS	cym
V;LIT;3;PL;IND;PST	cym
V;LIT;3;PL;IND;PST;PFV	cym
V;LIT;3;PL;SBJV	cym
V;LIT;3;SG;IMP	cym
V;LIT;3;SG;IND;IPFV	cym
V;LIT;3;SG;IND;PRS	cym
V;LIT;3;SG;IND;PST	cym
V;LIT;3;SG;IND;PST;PFV	cym
V;LIT;3;SG;SBJV	cym
V;LIT;4;IMP	cym
V;LIT;4;IND;IPFV	cym
V;LIT;4;IND;PRS	cym
V;LIT;4;IND;PST	cym
V;LIT;4;IND;PST;PFV	cym
V;LIT;4;SBJV	cym
V;MED;FUT	hai
V;NEG;3;PL;DRCT;PST	hai
V;NEG;3;PL;DRCT;PST;HAB	hai
V;NEG;3;PL;DUR	hai
V;NEG;3;PL;FUT;LGSPEC6	hai
V;NEG;3;PL;FUT;REFL;INT	hai
V;NEG;3;PL;IMMED;FUT	hai
V;NEG;3;PL;IMMED;PRS	hai
V;NEG;3;PL;INT;FUT;LGSPEC8	hai
V;NEG;3;PL;INT;FUT;REMT	hai
V;NEG;3;PL;INT;LGSPEC8;PRS	hai
V;NEG;3;PL;INT;MED;FUT	hai
V;NEG;3;PL;INT;PROX;FUT	hai
V;NEG;3;PL;INT;PRS;HAB	hai
V;NEG;3;PL;INT;PST	hai
V;NEG;3;PL;INT;PST;HAB	hai
V;NEG;3;PL;IRR;PRS	hai
V;NEG;3;PL;LGSPEC1;IMMED;PRS	hai
V;NEG;3;PL;LGSPEC1;INT;FUT	hai
V;NEG;3;PL;LGSPEC1;INT;PRS	hai
V;NEG;3;PL;LGSPEC1;INT;PST	hai
V;NEG;3;PL;LGSPEC1;INT;PST;HAB	hai
V;NEG;3;PL;LGSPEC1;LGSPEC8;PRS	hai
V;NEG;3;PL;LGSPEC2;FUT	hai
V;NEG;3;PL;LGSPEC2;PRS	hai
V;NEG;3;PL;LGSPEC2;PST	hai
V;NEG;3;PL;LGSPEC2;PST;HAB	hai
V;NEG;3;PL;LGSPEC2;REL	hai
V;NEG;3;PL;LGSPEC4;PST	hai
V;NEG;3;PL;LGSPEC4;PST;HAB	hai
V;NEG;3;PL;LGSPEC5;PST	hai
V;NEG;3;PL;LGSPEC6	hai
V;NEG;3;PL;LGSPEC7	hai
V;NEG;3;PL;LGSPEC8;FUT	hai
V;NEG;3;PL;LGSPEC8;PRS	hai
V;NEG;3;PL;LGSPEC9;MED;FUT	hai
V;NEG;3;PL;MED;FUT	hai
V;NEG;3;PL;PROX;FUT	hai
V;NEG;3;PL;PRS;HAB	hai
V;NEG;3;PL;PRS;HAB;LGSPEC6	hai
V;NEG;3;PL;PST;LGSPEC6	hai
V;NEG;3;PL;REFL	hai
V;NEG;3;PL;REL	hai
V;NEG;3;PL;REL;FUT	hai
V;NEG;3;PL;REL;LGSPEC3	hai
V;NEG;DRCT;PST	hai
V;NEG;DRCT;PST;HAB	hai
V;NEG;DUR	hai
V;NEG;FUT;LGSPEC6	hai
V;NEG;FUT;REFL;INT	hai
V;NEG;IMMED;FUT	hai
V;NEG;IMMED;PRS	hai
V;NEG;IMP;1;PL	spa
V;NEG;IMP;2;PL	spa
V;NEG;IMP;2;SG	ron, spa
V;NEG;IMP;3;PL	ron, spa
V;NEG;IMP;3;SG	spa
V;NEG;INT;FUT;LGSPEC8	hai
V;NEG;INT;FUT;REMT	hai
V;NEG;INT;LGSPEC8;PRS	hai
V;NEG;INT;MED;FUT	hai
V;NEG;INT;PROX;FUT	hai
V;NEG;INT;PRS;HAB	hai
V;NEG;INT;PST	hai
V;NEG;INT;PST;HAB	hai
V;NEG;IRR;PRS	hai
V;NEG;LGSPEC1;IMMED;PRS	hai
V;NEG;LGSPEC1;INT;FUT	hai
V;NEG;LGSPEC1;INT;PRS	hai
V;NEG;LGSPEC1;INT;PST	hai
V;NEG;LGSPEC1;INT;PST;HAB	hai
V;NEG;LGSPEC1;LGSPEC8;PRS	hai
V;NEG;LGSPEC2;FUT	hai
V;NEG;LGSPEC2;PRS	hai
V;NEG;LGSPEC2;PST	hai
V;NEG;LGSPEC2;PST;HAB	hai
V;NEG;LGSPEC2;REL	hai
V;NEG;LGSPEC4;PST	hai
V;NEG;LGSPEC4;PST;HAB	hai
V;NEG;LGSPEC5;PST	hai
V;NEG;LGSPEC6	hai
V;NEG;LGSPEC7	hai
V;NEG;LGSPEC8;FUT	hai
V;NEG;LGSPEC8;PRS	hai
V;NEG;MED;FUT	hai
V;NEG;PL;IMP	hai
V;NEG;PROX;FUT	hai
V;NEG;PRS;HAB	hai
V;NEG;PRS;HAB;LGSPEC6	hai
V;NEG;PST;LGSPEC6	hai
V;NEG;REFL	hai
V;NEG;REL	hai
V;NEG;REL;FUT	hai
V;NEG;REL;LGSPEC3	hai
V;NEG;SG;IMP	hai
V;NFIN	cat, ces, deu, eng, est, fao, fin.1, fin.2, fra, hun, isl, ita, lat, lav, nld, pol, por, que, ron, slv, spa, sqi
V;NFIN;1;PL	hun
V;NFIN;1;SG	hun
V;NFIN;2;PL	hun
V;NFIN;2;SG	hun
V;NFIN;3;PL	hun
V;NFIN;3;SG	hun
V;NFIN;AGT	que
V;NFIN;NEG	lav
V;NFIN;PASS	nno
V;NFIN;POS;INTR	klr
V;NFIN;POS;TR	klr
V;OPT;1;DU/PL	nav
V;OPT;1;PL	nav
V;OPT;1;SG	nav
V;OPT;2;DU/PL	nav
V;OPT;2;PL	nav
V;OPT;2;SG	nav
V;OPT;3;PL	nav
V;OPT;3;SG/DU/PL	nav
V;OPT;4;PL	nav
V;OPT;4;SG/DU/PL	nav
V;PASS;IND;PRS	dan, swe
V;PASS;IND;PST	dan, swe
V;PASS;NFIN	swe
V;PASS;PRS;NEG;COND	est, fin.1, fin.2
V;PASS;PRS;NEG;IMP	est, fin.1, fin.2
V;PASS;PRS;NEG;IND	est, fin.1, fin.2
V;PASS;PRS;NEG;POT	fin.1, fin.2
V;PASS;PRS;NEG;QUOT	est
V;PASS;PRS;POS;COND	est, fin.1, fin.2
V;PASS;PRS;POS;IMP	est, fin.1, fin.2
V;PASS;PRS;POS;IND	est, fin.1, fin.2
V;PASS;PRS;POS;POT	fin.1, fin.2
V;PASS;PRS;POS;QUOT	est
V;PASS;PRS;PRF;NEG;COND	est, fin.1, fin.2
V;PASS;PRS;PRF;NEG;IMP	est, fin.1, fin.2
V;PASS;PRS;PRF;NEG;IND	est, fin.1, fin.2
V;PASS;PRS;PRF;NEG;POT	fin.1, fin.2
V;PASS;PRS;PRF;NEG;QUOT	est
V;PASS;PRS;PRF;POS;COND	est, fin.1, fin.2
V;PASS;PRS;PRF;POS;IMP	est, fin.1, fin.2
V;PASS;PRS;PRF;POS;IND	est, fin.1, fin.2
V;PASS;PRS;PRF;POS;POT	fin.1, fin.2
V;PASS;PRS;PRF;POS;QUOT	est
V;PASS;PST;NEG;IND	est, fin.1, fin.2
V;PASS;PST;POS;IND	est, fin.1, fin.2
V;PASS;PST;PRF;NEG;IND	est, fin.1, fin.2
V;PASS;PST;PRF;POS;IND	est, fin.1, fin.2
V;PL;IMP	hai
V;POS;IMP;1;PL	cat, fra, ita, spa
V;POS;IMP;2;PL	cat, fra, ita, spa
V;POS;IMP;2;SG	cat, fra, ita, ron, spa
V;POS;IMP;3;PL	cat, ita, ron, spa
V;POS;IMP;3;SG	cat, ita, spa
V;POT;1;DU	sme
V;POT;1;PL	sme
V;POT;1;SG	sme
V;POT;2;DU	sme
V;POT;2;PL	sme
V;POT;2;SG	sme
V;POT;3;DU	sme
V;POT;3;PL	sme
V;POT;3;SG	sme
V;PROX;FUT	hai
V;PRS	nno, nob
V;PRS;1;DU	dsb
V;PRS;1;PL	dsb, pol
V;PRS;1;SG	dsb, pol, que
V;PRS;1+EXCL;PL	que
V;PRS;1+INCL;PL	que
V;PRS;2;DU	dsb
V;PRS;2;PL	dsb, pol, que
V;PRS;2;SG	dsb, pol, que
V;PRS;3;DU	dsb
V;PRS;3;PL	dsb, pol, que
V;PRS;3;SG	dsb, pol, que
V;PRS;HAB	hai
V;PRS;HAB;LGSPEC6	hai
V;PRS;IND;1;DU	sme
V;PRS;IND;1;PL	sme
V;PRS;IND;1;SG	sme
V;PRS;IND;2;DU	sme
V;PRS;IND;2;PL	sme
V;PRS;IND;2;SG	sme
V;PRS;IND;3;DU	sme
V;PRS;IND;3;PL	sme
V;PRS;IND;3;SG	sme
V;PRS;NEG;1;EXCL;DU;ARG2;ARGDU;TR	klr
V;PRS;NEG;1;EXCL;DU;ARG2;ARGPL;TR	klr
V;PRS;NEG;1;EXCL;DU;ARG2;ARGSG;TR	klr
V;PRS;NEG;1;EXCL;DU;ARG3;ARGDU;TR	klr
V;PRS;NEG;1;EXCL;DU;ARG3;ARGPL;TR	klr
V;PRS;NEG;1;EXCL;DU;ARG3;ARGSG;TR	klr
V;PRS;NEG;1;EXCL;DU;INTR	klr
V;PRS;NEG;1;EXCL;DU;REFL	klr
V;PRS;NEG;1;EXCL;PL;ARG2;ARGDU;TR	klr
V;PRS;NEG;1;EXCL;PL;ARG2;ARGPL;TR	klr
V;PRS;NEG;1;EXCL;PL;ARG2;ARGSG;TR	klr
V;PRS;NEG;1;EXCL;PL;ARG3;ARGDU;TR	klr
V;PRS;NEG;1;EXCL;PL;ARG3;ARGPL;TR	klr
V;PRS;NEG;1;EXCL;PL;ARG3;ARGSG;TR	klr
V;PRS;NEG;1;EXCL;PL;INTR	klr
V;PRS;NEG;1;EXCL;PL;REFL	klr
V;PRS;NEG;1;INCL;DU;ARG3;ARGDU;TR	klr
V;PRS;NEG;1;INCL;DU;ARG3;ARGPL;TR	klr
V;PRS;NEG;1;INCL;DU;ARG3;ARGSG;TR	klr
V;PRS;NEG;1;INCL;DU;INTR	klr
V;PRS;NEG;1;INCL;DU;REFL	klr
V;PRS;NEG;1;INCL;PL;ARG3;ARGDU;TR	klr
V;PRS;NEG;1;INCL;PL;ARG3;ARGPL;TR	klr
V;PRS;NEG;1;INCL;PL;ARG3;ARGSG;TR	klr
V;PRS;NEG;1;INCL;PL;INTR	klr
V;PRS;NEG;1;INCL;PL;REFL	klr
V;PRS;NEG;1;SG;ARG2;ARGDU;TR	klr
V;PRS;NEG;1;SG;ARG2;ARGPL;TR	klr
V;PRS;NEG;1;SG;ARG2;ARGSG;TR	klr
V;PRS;NEG;1;SG;ARG3;ARGDU;TR	klr
V;PRS;NEG;1;SG;ARG3;ARGPL;TR	klr
V;PRS;NEG;1;SG;ARG3;ARGSG;TR	klr
V;PRS;NEG;1;SG;INTR	klr
V;PRS;NEG;1;SG;REFL	klr
V;PRS;NEG;2;DU;ARG1;ARGEXCL;ARGDU;TR	klr
V;PRS;NEG;2;DU;ARG1;ARGEXCL;ARGPL;TR	klr
V;PRS;NEG;2;DU;ARG1;ARGSG;TR	klr
V;PRS;NEG;2;DU;ARG3;ARGDU;TR	klr
V;PRS;NEG;2;DU;ARG3;ARGPL;TR	klr
V;PRS;NEG;2;DU;ARG3;ARGSG;TR	klr
V;PRS;NEG;2;DU;INTR	klr
V;PRS;NEG;2;DU;REFL	klr
V;PRS;NEG;2;PL;ARG1;ARGEXCL;ARGDU;TR	klr
V;PRS;NEG;2;PL;ARG1;ARGEXCL;ARGPL;TR	klr
V;PRS;NEG;2;PL;ARG1;ARGSG;TR	klr
V;PRS;NEG;2;PL;ARG3;ARGDU;TR	klr
V;PRS;NEG;2;PL;ARG3;ARGPL;TR	klr
V;PRS;NEG;2;PL;ARG3;ARGSG;TR	klr
V;PRS;NEG;2;PL;INTR	klr
V;PRS;NEG;2;PL;REFL	klr
V;PRS;NEG;2;SG;ARG1;ARGEXCL;ARGDU;TR	klr
V;PRS;NEG;2;SG;ARG1;ARGEXCL;ARGPL;TR	klr
V;PRS;NEG;2;SG;ARG1;ARGSG;TR	klr
V;PRS;NEG;2;SG;ARG3;ARGDU;TR	klr
V;PRS;NEG;2;SG;ARG3;ARGPL;TR	klr
V;PRS;NEG;2;SG;ARG3;ARGSG;TR	klr
V;PRS;NEG;2;SG;INTR	klr
V;PRS;NEG;2;SG;REFL	klr
V;PRS;NEG;3;DU;ARG1;ARGEXCL;ARGDU;TR	klr
V;PRS;NEG;3;DU;ARG1;ARGEXCL;ARGPL;TR	klr
V;PRS;NEG;3;DU;ARG1;ARGINCL;ARGDU;TR	klr
V;PRS;NEG;3;DU;ARG1;ARGINCL;ARGPL;TR	klr
V;PRS;NEG;3;DU;ARG1;ARGSG;TR	klr
V;PRS;NEG;3;DU;ARG2;ARGDU;TR	klr
V;PRS;NEG;3;DU;ARG2;ARGPL;TR	klr
V;PRS;NEG;3;DU;ARG2;ARGSG;TR	klr
V;PRS;NEG;3;DU;ARG3;ARGDU;TR	klr
V;PRS;NEG;3;DU;ARG3;ARGPL;TR	klr
V;PRS;NEG;3;DU;ARG3;ARGSG;TR	klr
V;PRS;NEG;3;DU;INTR	klr
V;PRS;NEG;3;DU;REFL	klr
V;PRS;NEG;3;PL;ARG1;ARGEXCL;ARGDU;TR	klr
V;PRS;NEG;3;PL;ARG1;ARGEXCL;ARGPL;TR	klr
V;PRS;NEG;3;PL;ARG1;ARGINCL;ARGDU;TR	klr
V;PRS;NEG;3;PL;ARG1;ARGINCL;ARGPL;TR	klr
V;PRS;NEG;3;PL;ARG1;ARGSG;TR	klr
V;PRS;NEG;3;PL;ARG2;ARGDU;TR	klr
V;PRS;NEG;3;PL;ARG2;ARGPL;TR	klr
V;PRS;NEG;3;PL;ARG2;ARGSG;TR	klr
V;PRS;NEG;3;PL;ARG3;ARGDU;TR	klr
V;PRS;NEG;3;PL;ARG3;ARGPL;TR	klr
V;PRS;NEG;3;PL;ARG3;ARGSG;TR	klr
V;PRS;NEG;3;PL;INTR	klr
V;PRS;NEG;3;PL;REFL	klr
V;PRS;NEG;3;SG;ARG1;ARGEXCL;ARGDU;TR	klr
V;PRS;NEG;3;SG;ARG1;ARGEXCL;ARGPL;TR	klr
V;PRS;NEG;3;SG;ARG1;ARGINCL;ARGDU;TR	klr
V;PRS;NEG;3;SG;ARG1;ARGINCL;ARGPL;TR	klr
V;PRS;NEG;3;SG;ARG1;ARGSG;TR	klr
V;PRS;NEG;3;SG;ARG2;ARGDU;TR	klr
V;PRS;NEG;3;SG;ARG2;ARGPL;TR	klr
V;PRS;NEG;3;SG;ARG2;ARGSG;TR	klr
V;PRS;NEG;3;SG;ARG3;ARGDU;TR	klr
V;PRS;NEG;3;SG;ARG3;ARGPL;TR	klr
V;PRS;NEG;3;SG;ARG3;ARGSG;TR	klr
V;PRS;NEG;3;SG;INTR	klr
V;PRS;NEG;3;SG;REFL	klr
V;PRS;POS;1;EXCL;DU;ARG2;ARGDU;TR	klr
V;PRS;POS;1;EXCL;DU;ARG2;ARGPL;TR	klr
V;PRS;POS;1;EXCL;DU;ARG2;ARGSG;TR	klr
V;PRS;POS;1;EXCL;DU;ARG3;ARGDU;TR	klr
V;PRS;POS;1;EXCL;DU;ARG3;ARGPL;TR	klr
V;PRS;POS;1;EXCL;DU;ARG3;ARGSG;TR	klr
V;PRS;POS;1;EXCL;DU;INTR	klr
V;PRS;POS;1;EXCL;DU;REFL	klr
V;PRS;POS;1;EXCL;PL;ARG2;ARGDU;TR	klr
V;PRS;POS;1;EXCL;PL;ARG2;ARGPL;TR	klr
V;PRS;POS;1;EXCL;PL;ARG2;ARGSG;TR	klr
V;PRS;POS;1;EXCL;PL;ARG3;ARGDU;TR	klr
V;PRS;POS;1;EXCL;PL;ARG3;ARGPL;TR	klr
V;PRS;POS;1;EXCL;PL;ARG3;ARGSG;TR	klr
V;PRS;POS;1;EXCL;PL;INTR	klr
V;PRS;POS;1;EXCL;PL;REFL	klr
V;PRS;POS;1;INCL;DU;ARG3;ARGDU;TR	klr
V;PRS;POS;1;INCL;DU;ARG3;ARGPL;TR	klr
V;PRS;POS;1;INCL;DU;ARG3;ARGSG;TR	klr
V;PRS;POS;1;INCL;DU;INTR	klr
V;PRS;POS;1;INCL;DU;REFL	klr
V;PRS;POS;1;INCL;PL;ARG3;ARGDU;TR	klr
V;PRS;POS;1;INCL;PL;ARG3;ARGPL;TR	klr
V;PRS;POS;1;INCL;PL;ARG3;ARGSG;TR	klr
V;PRS;POS;1;INCL;PL;INTR	klr
V;PRS;POS;1;INCL;PL;REFL	klr
V;PRS;POS;1;SG;ARG2;ARGDU;TR	klr
V;PRS;POS;1;SG;ARG2;ARGPL;TR	klr
V;PRS;POS;1;SG;ARG2;ARGSG;TR	klr
V;PRS;POS;1;SG;ARG3;ARGDU;TR	klr
V;PRS;POS;1;SG;ARG3;ARGPL;TR	klr
V;PRS;POS;1;SG;ARG3;ARGSG;TR	klr
V;PRS;POS;1;SG;INTR	klr
V;PRS;POS;1;SG;REFL	klr
V;PRS;POS;2;DU;ARG1;ARGEXCL;ARGDU;TR	klr
V;PRS;POS;2;DU;ARG1;ARGEXCL;ARGPL;TR	klr
V;PRS;POS;2;DU;ARG1;ARGSG;TR	klr
V;PRS;POS;2;DU;ARG3;ARGDU;TR	klr
V;PRS;POS;2;DU;ARG3;ARGPL;TR	klr
V;PRS;POS;2;DU;ARG3;ARGSG;TR	klr
V;PRS;POS;2;DU;INTR	klr
V;PRS;POS;2;DU;REFL	klr
V;PRS;POS;2;PL;ARG1;ARGEXCL;ARGDU;TR	klr
V;PRS;POS;2;PL;ARG1;ARGEXCL;ARGPL;TR	klr
V;PRS;POS;2;PL;ARG1;ARGSG;TR	klr
V;PRS;POS;2;PL;ARG3;ARGDU;TR	klr
V;PRS;POS;2;PL;ARG3;ARGPL;TR	klr
V;PRS;POS;2;PL;ARG3;ARGSG;TR	klr
V;PRS;POS;2;PL;INTR	klr
V;PRS;POS;2;PL;REFL	klr
V;PRS;POS;2;SG;ARG1;ARGEXCL;ARGDU;TR	klr
V;PRS;POS;2;SG;ARG1;ARGEXCL;ARGPL;TR	klr
V;PRS;POS;2;SG;ARG1;ARGSG;TR	klr
V;PRS;POS;2;SG;ARG3;ARGDU;TR	klr
V;PRS;POS;2;SG;ARG3;ARGPL;TR	klr
V;PRS;POS;2;SG;ARG3;ARGSG;TR	klr
V;PRS;POS;2;SG;INTR	klr
V;PRS;POS;2;SG;REFL	klr
V;PRS;POS;3;DU;ARG1;ARGEXCL;ARGDU;TR	klr
V;PRS;POS;3;DU;ARG1;ARGEXCL;ARGPL;TR	klr
V;PRS;POS;3;DU;ARG1;ARGINCL;ARGDU;TR	klr
V;PRS;POS;3;DU;ARG1;ARGINCL;ARGPL;TR	klr
V;PRS;POS;3;DU;ARG1;ARGSG;TR	klr
V;PRS;POS;3;DU;ARG2;ARGDU;TR	klr
V;PRS;POS;3;DU;ARG2;ARGPL;TR	klr
V;PRS;POS;3;DU;ARG2;ARGSG;TR	klr
V;PRS;POS;3;DU;ARG3;ARGDU;TR	klr
V;PRS;POS;3;DU;ARG3;ARGPL;TR	klr
V;PRS;POS;3;DU;ARG3;ARGSG;TR	klr
V;PRS;POS;3;DU;INTR	klr
V;PRS;POS;3;DU;REFL	klr
V;PRS;POS;3;PL;ARG1;ARGEXCL;ARGDU;TR	klr
V;PRS;POS;3;PL;ARG1;ARGEXCL;ARGPL;TR	klr
V;PRS;POS;3;PL;ARG1;ARGINCL;ARGDU;TR	klr
V;PRS;POS;3;PL;ARG1;ARGINCL;ARGPL;TR	klr
V;PRS;POS;3;PL;ARG1;ARGSG;TR	klr
V;PRS;POS;3;PL;ARG2;ARGDU;TR	klr
V;PRS;POS;3;PL;ARG2;ARGPL;TR	klr
V;PRS;POS;3;PL;ARG2;ARGSG;TR	klr
V;PRS;POS;3;PL;ARG3;ARGDU;TR	klr
V;PRS;POS;3;PL;ARG3;ARGPL;TR	klr
V;PRS;POS;3;PL;ARG3;ARGSG;TR	klr
V;PRS;POS;3;PL;INTR	klr
V;PRS;POS;3;PL;REFL	klr
V;PRS;POS;3;SG;ARG1;ARGEXCL;ARGDU;TR	klr
V;PRS;POS;3;SG;ARG1;ARGEXCL;ARGPL;TR	klr
V;PRS;POS;3;SG;ARG1;ARGINCL;ARGDU;TR	klr
V;PRS;POS;3;SG;ARG1;ARGINCL;ARGPL;TR	klr
V;PRS;POS;3;SG;ARG1;ARGSG;TR	klr
V;PRS;POS;3;SG;ARG2;ARGDU;TR	klr
V;PRS;POS;3;SG;ARG2;ARGPL;TR	klr
V;PRS;POS;3;SG;ARG2;ARGSG;TR	klr
V;PRS;POS;3;SG;ARG3;ARGDU;TR	klr
V;PRS;POS;3;SG;ARG3;ARGPL;TR	klr
V;PRS;POS;3;SG;ARG3;ARGSG;TR	klr
V;PRS;POS;3;SG;INTR	klr
V;PRS;POS;3;SG;REFL	klr
V;PST	eng, nno, nob
V;PST;1;DU	dsb
V;PST;1;PL	dsb, pol
V;PST;1;PL;MASC;HUM	pol
V;PST;1;SG	dsb
V;PST;1;SG;FEM	pol
V;PST;1;SG;MASC	pol
V;PST;2;DU	dsb
V;PST;2;PL	dsb, pol
V;PST;2;PL;MASC;HUM	pol
V;PST;2;SG	dsb
V;PST;2;SG;FEM	pol
V;PST;2;SG;MASC	pol
V;PST;3;DU	dsb
V;PST;3;PL	dsb, pol
V;PST;3;PL;MASC;HUM	pol
V;PST;3;SG	dsb
V;PST;3;SG;FEM	pol
V;PST;3;SG;MASC	pol
V;PST;3;SG;NEUT	pol
V;PST;ACT	gla
V;PST;FH;1;SG	que
V;PST;FH;1+EXCL;PL	que
V;PST;FH;1+INCL;PL	que
V;PST;FH;2;PL	que
V;PST;FH;2;SG	que
V;PST;FH;3;PL	que
V;PST;FH;3;SG	que
V;PST;IND;1;DU	sme
V;PST;IND;1;PL	sme
V;PST;IND;1;SG	sme
V;PST;IND;2;DU	sme
V;PST;IND;2;PL	sme
V;PST;IND;2;SG	sme
V;PST;IND;3;DU	sme
V;PST;IND;3;PL	sme
V;PST;IND;3;SG	sme
V;PST;LGSPEC6	hai
V;PST;NEG;1;EXCL;DU;ARG2;ARGDU;TR	klr
V;PST;NEG;1;EXCL;DU;ARG2;ARGPL;TR	klr
V;PST;NEG;1;EXCL;DU;ARG2;ARGSG;TR	klr
V;PST;NEG;1;EXCL;DU;ARG3;ARGDU;TR	klr
V;PST;NEG;1;EXCL;DU;ARG3;ARGPL;TR	klr
V;PST;NEG;1;EXCL;DU;ARG3;ARGSG;TR	klr
V;PST;NEG;1;EXCL;DU;INTR	klr
V;PST;NEG;1;EXCL;DU;REFL	klr
V;PST;NEG;1;EXCL;PL;ARG2;ARGDU;TR	klr
V;PST;NEG;1;EXCL;PL;ARG2;ARGPL;TR	klr
V;PST;NEG;1;EXCL;PL;ARG2;ARGSG;TR	klr
V;PST;NEG;1;EXCL;PL;ARG3;ARGDU;TR	klr
V;PST;NEG;1;EXCL;PL;ARG3;ARGPL;TR	klr
V;PST;NEG;1;EXCL;PL;ARG3;ARGSG;TR	klr
V;PST;NEG;1;EXCL;PL;INTR	klr
V;PST;NEG;1;EXCL;PL;REFL	klr
V;PST;NEG;1;INCL;DU;ARG3;ARGDU;TR	klr
V;PST;NEG;1;INCL;DU;ARG3;ARGPL;TR	klr
V;PST;NEG;1;INCL;DU;ARG3;ARGSG;TR	klr
V;PST;NEG;1;INCL;DU;INTR	klr
V;PST;NEG;1;INCL;DU;REFL	klr
V;PST;NEG;1;INCL;PL;ARG3;ARGDU;TR	klr
V;PST;NEG;1;INCL;PL;ARG3;ARGPL;TR	klr
V;PST;NEG;1;INCL;PL;ARG3;ARGSG;TR	klr
V;PST;NEG;1;INCL;PL;INTR	klr
V;PST;NEG;1;INCL;PL;REFL	klr
V;PST;NEG;1;SG;ARG2;ARGDU;TR	klr
V;PST;NEG;1;SG;ARG2;ARGPL;TR	klr
V;PST;NEG;1;SG;ARG2;ARGSG;TR	klr
V;PST;NEG;1;SG;ARG3;ARGDU;TR	klr
V;PST;NEG;1;SG;ARG3;ARGPL;TR	klr
V;PST;NEG;1;SG;ARG3;ARGSG;TR	klr
V;PST;NEG;1;SG;INTR	klr
V;PST;NEG;1;SG;REFL	klr
V;PST;NEG;2;DU;ARG1;ARGEXCL;ARGDU;TR	klr
V;PST;NEG;2;DU;ARG1;ARGEXCL;ARGPL;TR	klr
V;PST;NEG;2;DU;ARG3;ARGDU;TR	klr
V;PST;NEG;2;DU;ARG3;ARGPL;TR	klr
V;PST;NEG;2;DU;ARG3;ARGSG;TR	klr
V;PST;NEG;2;DU;INTR	klr
V;PST;NEG;2;DU;REFL	klr
V;PST;NEG;2;PL;ARG1;ARGEXCL;ARGDU;TR	klr
V;PST;NEG;2;PL;ARG1;ARGEXCL;ARGPL;TR	klr
V;PST;NEG;2;PL;ARG3;ARGDU;TR	klr
V;PST;NEG;2;PL;ARG3;ARGPL;TR	klr
V;PST;NEG;2;PL;ARG3;ARGSG;TR	klr
V;PST;NEG;2;PL;INTR	klr
V;PST;NEG;2;PL;REFL	klr
V;PST;NEG;2;SG;ARG1;ARGEXCL;ARGDU;TR	klr
V;PST;NEG;2;SG;ARG1;ARGEXCL;ARGPL;TR	klr
V;PST;NEG;2;SG;ARG3;ARGDU;TR	klr
V;PST;NEG;2;SG;ARG3;ARGPL;TR	klr
V;PST;NEG;2;SG;ARG3;ARGSG;TR	klr
V;PST;NEG;2;SG;INTR	klr
V;PST;NEG;2;SG;REFL	klr
V;PST;NEG;3;DU;ARG1;ARGEXCL;ARGDU;TR	klr
V;PST;NEG;3;DU;ARG1;ARGEXCL;ARGPL;TR	klr
V;PST;NEG;3;DU;ARG1;ARGINCL;ARGDU;TR	klr
V;PST;NEG;3;DU;ARG1;ARGINCL;ARGPL;TR	klr
V;PST;NEG;3;DU;ARG1;ARGSG;TR	klr
V;PST;NEG;3;DU;ARG2;ARGDU;TR	klr
V;PST;NEG;3;DU;ARG2;ARGPL;TR	klr
V;PST;NEG;3;DU;ARG2;ARGSG;TR	klr
V;PST;NEG;3;DU;ARG3;ARGDU;TR	klr
V;PST;NEG;3;DU;ARG3;ARGPL;TR	klr
V;PST;NEG;3;DU;ARG3;ARGSG;TR	klr
V;PST;NEG;3;DU;INTR	klr
V;PST;NEG;3;DU;REFL	klr
V;PST;NEG;3;PL;ARG1;ARGEXCL;ARGDU;TR	klr
V;PST;NEG;3;PL;ARG1;ARGEXCL;ARGPL;TR	klr
V;PST;NEG;3;PL;ARG1;ARGINCL;ARGDU;TR	klr
V;PST;NEG;3;PL;ARG1;ARGINCL;ARGPL;TR	klr
V;PST;NEG;3;PL;ARG1;ARGSG;TR	klr
V;PST;NEG;3;PL;ARG2;ARGDU;TR	klr
V;PST;NEG;3;PL;ARG2;ARGPL;TR	klr
V;PST;NEG;3;PL;ARG2;ARGSG;TR	klr
V;PST;NEG;3;PL;ARG3;ARGDU;TR	klr
V;PST;NEG;3;PL;ARG3;ARGPL;TR	klr
V;PST;NEG;3;PL;ARG3;ARGSG;TR	klr
V;PST;NEG;3;PL;INTR	klr
V;PST;NEG;3;PL;REFL	klr
V;PST;NEG;3;SG;ARG1;ARGEXCL;ARGDU;TR	klr
V;PST;NEG;3;SG;ARG1;ARGEXCL;ARGPL;TR	klr
V;PST;NEG;3;SG;ARG1;ARGINCL;ARGDU;TR	klr
V;PST;NEG;3;SG;ARG1;ARGINCL;ARGPL;TR	klr
V;PST;NEG;3;SG;ARG1;ARGSG;TR	klr
V;PST;NEG;3;SG;ARG2;ARGDU;TR	klr
V;PST;NEG;3;SG;ARG2;ARGPL;TR	klr
V;PST;NEG;3;SG;ARG2;ARGSG;TR	klr
V;PST;NEG;3;SG;ARG3;ARGDU;TR	klr
V;PST;NEG;3;SG;ARG3;ARGPL;TR	klr
V;PST;NEG;3;SG;ARG3;ARGSG;TR	klr
V;PST;NEG;3;SG;INTR	klr
V;PST;NEG;3;SG;REFL	klr
V;PST;NFH;1;SG	que
V;PST;NFH;1+EXCL;PL	que
V;PST;NFH;1+INCL;PL	que
V;PST;NFH;2;PL	que
V;PST;NFH;2;SG	que
V;PST;NFH;3;PL	que
V;PST;NFH;3;SG	que
V;PST;PASS	gla
V;PST;POS;1;EXCL;DU;ARG2;ARGDU;TR	klr
V;PST;POS;1;EXCL;DU;ARG2;ARGPL;TR	klr
V;PST;POS;1;EXCL;DU;ARG2;ARGSG;TR	klr
V;PST;POS;1;EXCL;DU;ARG3;ARGDU;TR	klr
V;PST;POS;1;EXCL;DU;ARG3;ARGPL;TR	klr
V;PST;POS;1;EXCL;DU;ARG3;ARGSG;TR	klr
V;PST;POS;1;EXCL;DU;INTR	klr
V;PST;POS;1;EXCL;DU;REFL	klr
V;PST;POS;1;EXCL;PL;ARG2;ARGDU;TR	klr
V;PST;POS;1;EXCL;PL;ARG2;ARGPL;TR	klr
V;PST;POS;1;EXCL;PL;ARG2;ARGSG;TR	klr
V;PST;POS;1;EXCL;PL;ARG3;ARGDU;TR	klr
V;PST;POS;1;EXCL;PL;ARG3;ARGPL;TR	klr
V;PST;POS;1;EXCL;PL;ARG3;ARGSG;TR	klr
V;PST;POS;1;EXCL;PL;INTR	klr
V;PST;POS;1;EXCL;PL;REFL	klr
V;PST;POS;1;INCL;DU;ARG3;ARGDU;TR	klr
V;PST;POS;1;INCL;DU;ARG3;ARGPL;TR	klr
V;PST;POS;1;INCL;DU;ARG3;ARGSG;TR	klr
V;PST;POS;1;INCL;DU;INTR	klr
V;PST;POS;1;INCL;DU;REFL	klr
V;PST;POS;1;INCL;PL;ARG3;ARGDU;TR	klr
V;PST;POS;1;INCL;PL;ARG3;ARGPL;TR	klr
V;PST;POS;1;INCL;PL;ARG3;ARGSG;TR	klr
V;PST;POS;1;INCL;PL;INTR	klr
V;PST;POS;1;INCL;PL;REFL	klr
V;PST;POS;1;SG;ARG2;ARGDU;TR	klr
V;PST;POS;1;SG;ARG2;ARGPL;TR	klr
V;PST;POS;1;SG;ARG2;ARGSG;TR	klr
V;PST;POS;1;SG;ARG3;ARGDU;TR	klr
V;PST;POS;1;SG;ARG3;ARGPL;TR	klr
V;PST;POS;1;SG;ARG3;ARGSG;TR	klr
V;PST;POS;1;SG;INTR	klr
V;PST;POS;1;SG;REFL	klr
V;PST;POS;2;DU;ARG1;ARGEXCL;ARGDU;TR	klr
V;PST;POS;2;DU;ARG1;ARGEXCL;ARGPL;TR	klr
V;PST;POS;2;DU;ARG3;ARGDU;TR	klr
V;PST;POS;2;DU;ARG3;ARGPL;TR	klr
V;PST;POS;2;DU;ARG3;ARGSG;TR	klr
V;PST;POS;2;DU;INTR	klr
V;PST;POS;2;DU;REFL	klr
V;PST;POS;2;PL;ARG1;ARGEXCL;ARGDU;TR	klr
V;PST;POS;2;PL;ARG1;ARGEXCL;ARGPL;TR	klr
V;PST;POS;2;PL;ARG3;ARGDU;TR	klr
V;PST;POS;2;PL;ARG3;ARGPL;TR	klr
V;PST;POS;2;PL;ARG3;ARGSG;TR	klr
V;PST;POS;2;PL;INTR	klr
V;PST;POS;2;PL;REFL	klr
V;PST;POS;2;SG;ARG1;ARGEXCL;ARGDU;TR	klr
V;PST;POS;2;SG;ARG1;ARGEXCL;ARGPL;TR	klr
V;PST;POS;2;SG;ARG3;ARGDU;TR	klr
V;PST;POS;2;SG;ARG3;ARGPL;TR	klr
V;PST;POS;2;SG;ARG3;ARGSG;TR	klr
V;PST;POS;2;SG;INTR	klr
V;PST;POS;2;SG;REFL	klr
V;PST;POS;3;DU;ARG1;ARGEXCL;ARGDU;TR	klr
V;PST;POS;3;DU;ARG1;ARGEXCL;ARGPL;TR	klr
V;PST;POS;3;DU;ARG1;ARGINCL;ARGDU;TR	klr
V;PST;POS;3;DU;ARG1;ARGINCL;ARGPL;TR	klr
V;PST;POS;3;DU;ARG1;ARGSG;TR	klr
V;PST;POS;3;DU;ARG2;ARGDU;TR	klr
V;PST;POS;3;DU;ARG2;ARGPL;TR	klr
V;PST;POS;3;DU;ARG2;ARGSG;TR	klr
V;PST;POS;3;DU;ARG3;ARGDU;TR	klr
V;PST;POS;3;DU;ARG3;ARGPL;TR	klr
V;PST;POS;3;DU;ARG3;ARGSG;TR	klr
V;PST;POS;3;DU;INTR	klr
V;PST;POS;3;DU;REFL	klr
V;PST;POS;3;PL;ARG1;ARGEXCL;ARGDU;TR	klr
V;PST;POS;3;PL;ARG1;ARGEXCL;ARGPL;TR	klr
V;PST;POS;3;PL;ARG1;ARGINCL;ARGDU;TR	klr
V;PST;POS;3;PL;ARG1;ARGINCL;ARGPL;TR	klr
V;PST;POS;3;PL;ARG1;ARGSG;TR	klr
V;PST;POS;3;PL;ARG2;ARGDU;TR	klr
V;PST;POS;3;PL;ARG2;ARGPL;TR	klr
V;PST;POS;3;PL;ARG2;ARGSG;TR	klr
V;PST;POS;3;PL;ARG3;ARGDU;TR	klr
V;PST;POS;3;PL;ARG3;ARGPL;TR	klr
V;PST;POS;3;PL;ARG3;ARGSG;TR	klr
V;PST;POS;3;PL;INTR	klr
V;PST;POS;3;PL;REFL	klr
V;PST;POS;3;SG;ARG1;ARGEXCL;ARGDU;TR	klr
V;PST;POS;3;SG;ARG1;ARGEXCL;ARGPL;TR	klr
V;PST;POS;3;SG;ARG1;ARGINCL;ARGDU;TR	klr
V;PST;POS;3;SG;ARG1;ARGINCL;ARGPL;TR	klr
V;PST;POS;3;SG;ARG1;ARGSG;TR	klr
V;PST;POS;3;SG;ARG2;ARGDU;TR	klr
V;PST;POS;3;SG;ARG2;ARGPL;TR	klr
V;PST;POS;3;SG;ARG2;ARGSG;TR	klr
V;PST;POS;3;SG;ARG3;ARGDU;TR	klr
V;PST;POS;3;SG;ARG3;ARGPL;TR	klr
V;PST;POS;3;SG;ARG3;ARGSG;TR	klr
V;PST;POS;3;SG;INTR	klr
V;PST;POS;3;SG;REFL	klr
V;REAL;IPFV/PROG;1;DU/PL	nav
V;REAL;IPFV/PROG;1;PL	nav
V;REAL;IPFV/PROG;1;SG	nav
V;REAL;IPFV/PROG;2;DU/PL	nav
V;REAL;IPFV/PROG;2;PL	nav
V;REAL;IPFV/PROG;2;SG	nav
V;REAL;IPFV/PROG;3;PL	nav
V;REAL;IPFV/PROG;3;SG/DU/PL	nav
V;REAL;IPFV/PROG;4;PL	nav
V;REAL;IPFV/PROG;4;SG/DU/PL	nav
V;REAL;ITER;1;DU/PL	nav
V;REAL;ITER;1;PL	nav
V;REAL;ITER;1;SG	nav
V;REAL;ITER;2;DU/PL	nav
V;REAL;ITER;2;PL	nav
V;REAL;ITER;2;SG	nav
V;REAL;ITER;3;PL	nav
V;REAL;ITER;3;SG/DU/PL	nav
V;REAL;ITER;4;PL	nav
V;REAL;ITER;4;SG/DU/PL	nav
V;REAL;PFV/PRF;1;DU/PL	nav
V;REAL;PFV/PRF;1;PL	nav
V;REAL;PFV/PRF;1;SG	nav
V;REAL;PFV/PRF;2;DU/PL	nav
V;REAL;PFV/PRF;2;PL	nav
V;REAL;PFV/PRF;2;SG	nav
V;REAL;PFV/PRF;3;PL	nav
V;REAL;PFV/PRF;3;SG/DU/PL	nav
V;REAL;PFV/PRF;4;PL	nav
V;REAL;PFV/PRF;4;SG/DU/PL	nav
V;REAL;PROSP;1;DU/PL	nav
V;REAL;PROSP;1;PL	nav
V;REAL;PROSP;1;SG	nav
V;REAL;PROSP;2;DU/PL	nav
V;REAL;PROSP;2;PL	nav
V;REAL;PROSP;2;SG	nav
V;REAL;PROSP;3;PL	nav
V;REAL;PROSP;3;SG/DU/PL	nav
V;REAL;PROSP;4;PL	nav
V;REAL;PROSP;4;SG/DU/PL	nav
V;REFL	hai
V;REL	hai
V;REL;COND	gle
V;REL;FUT	hai
V;REL;FUT;IND	gle
V;REL;LGSPEC3	hai
V;REL;PRS;IND	gle
V;REL;PST;HAB;IND	gle
V;REL;PST;IND	gle
V;SBJV;FUT;1;PL	spa
V;SBJV;FUT;1;SG	spa
V;SBJV;FUT;2;PL	spa
V;SBJV;FUT;2;SG	spa
V;SBJV;FUT;3;PL	spa
V;SBJV;FUT;3;SG	spa
V;SBJV;PASS:PRS;1;PL	lat
V;SBJV;PASS;PRS;1;SG	lat
V;SBJV;PASS;PRS;2;PL	lat
V;SBJV;PASS;PRS;2;SG	lat
V;SBJV;PASS;PRS;3;PL	lat
V;SBJV;PASS;PRS;3;SG	lat
V;SBJV;PASS;PST;1;PL;IPFV	lat
V;SBJV;PASS;PST;1;SG;IPFV	lat
V;SBJV;PASS;PST;2;PL;IPFV	lat
V;SBJV;PASS;PST;3;PL;IPFV	lat
V;SBJV;PASS;PST;3;SG;IPFV	lat
V;SBJV;PRS;1;PL	cat, deu, fra, isl, ita, lat, ron, spa
V;SBJV;PRS;1;SG	cat, deu, fra, isl, ita, lat, ron, spa
V;SBJV;PRS;2;PL	cat, deu, fra, isl, ita, lat, ron, spa
V;SBJV;PRS;2;SG	cat, deu, fra, isl, ita, lat, ron, spa
V;SBJV;PRS;3;PL	cat, deu, fra, isl, ita, lat, ron, spa
V;SBJV;PRS;3;SG	cat, deu, fra, isl, ita, lat, ron, spa
V;SBJV;PRS;DEF;1;PL	hun
V;SBJV;PRS;DEF;1;SG	hun
V;SBJV;PRS;DEF;2;PL	hun
V;SBJV;PRS;DEF;2;SG	hun
V;SBJV;PRS;DEF;3;PL	hun
V;SBJV;PRS;DEF;3;SG	hun
V;SBJV;PRS;INDF;1;PL	hun
V;SBJV;PRS;INDF;1;SG	hun
V;SBJV;PRS;INDF;2;PL	hun
V;SBJV;PRS;INDF;2;SG	hun
V;SBJV;PRS;INDF;3;PL	hun
V;SBJV;PRS;INDF;3;SG	hun
V;SBJV;PRS;PL	nld
V;SBJV;PRS;SG	nld
V;SBJV;PST;1;PL	cat, deu, fra, isl, ita, spa
V;SBJV;PST;1;PL;IPFV	lat
V;SBJV;PST;1;PL;LGSPEC1	spa
V;SBJV;PST;1;PL;PFV	lat
V;SBJV;PST;1;PL;PRF	lat
V;SBJV;PST;1;SG	cat, deu, fra, isl, ita, spa
V;SBJV;PST;1;SG;IPFV	lat
V;SBJV;PST;1;SG;LGSPEC1	spa
V;SBJV;PST;1;SG;PFV	lat
V;SBJV;PST;1;SG;PRF	lat
V;SBJV;PST;2;PL	cat, deu, fra, isl, ita, spa
V;SBJV;PST;2;PL;IPFV	lat
V;SBJV;PST;2;PL;LGSPEC1	spa
V;SBJV;PST;2;PL;PFV	lat
V;SBJV;PST;2;PL;PRF	lat
V;SBJV;PST;2;SG	cat, deu, fra, isl, ita, spa
V;SBJV;PST;2;SG;IPFV	lat
V;SBJV;PST;2;SG;LGSPEC1	spa
V;SBJV;PST;2;SG;PFV	lat
V;SBJV;PST;2;SG;PRF	lat
V;SBJV;PST;3;PL	cat, deu, fra, isl, ita, spa
V;SBJV;PST;3;PL;IPFV	lat
V;SBJV;PST;3;PL;LGSPEC1	spa
V;SBJV;PST;3;PL;PFV	lat
V;SBJV;PST;3;PL;PRF	lat
V;SBJV;PST;3;SG	cat, deu, fra, isl, ita, spa
V;SBJV;PST;3;SG;IPFV	lat
V;SBJV;PST;3;SG;LGSPEC1	spa
V;SBJV;PST;3;SG;PFV	lat
V;SBJV;PST;3;SG;PRF	lat
V;SBJV;PST;PL	nld
V;SBJV;PST;SG	nld
V;SG;IMP	hai
V;V.MSDR	cym, gle, lav
V;V.MSDR;ACC	kmr
V;V.PTCP	cym, sqi
V;V.PTCP;ADV;FUT;ACT	lit
V;V.PTCP;ADV;LGSPEC2;ACT	lit
V;V.PTCP;ADV;PRS;ACT	lit
V;V.PTCP;ADV;PST;ACT	lit
V;V.PTCP;ADV;PST;FREQ;ACT	lit
V;V.PTCP;FUT;ACT	lit
V;V.PTCP;FUT;PASS	lit
V;V.PTCP;LGSPEC1;PASS	lit
V;V.PTCP;LGSPEC3	lit
V;V.PTCP;PRS	eng, gla, nno, nob, sqi
V;V.PTCP;PRS;ACT	lit
V;V.PTCP;PRS;LGSPEC3	lav
V;V.PTCP;PRS;LGSPEC4	lav
V;V.PTCP;PRS;LGSPEC5	lav
V;V.PTCP;PRS;LGSPEC6	lav
V;V.PTCP;PRS;PASS	lav, lit
V;V.PTCP;PST	eng, gle, nno, nob, sqi
V;V.PTCP;PST;ACT	lav, lit
V;V.PTCP;PST;FREQ;ACT	lit
V;V.PTCP;PST;PASS	lav, lit